id,txn_id,status,get_slot,landed_slot,slot_delta,time_at_txn_sent,time_taken_processed
3,63oKEUsEa1UYdnGBw4wiahNW1T4NFd12V7wBSNUbMX3xHQJePx8FwcGraxpnyn9xqLgavPs1pMJ9Dsxzo5jHFLDv,true,293321891,293321896,5,1727896524,5461
5,42tyjnYhF8WVQEZQhXgKgjHqqPcrZXGvYgvknyLsnLTWTtkpUiyYqdiLP3x1Qp4xh9dCiEknDRhtKsaGX6HfuQcU,true,293321891,293321896,5,1727896524,5493
2,28fSQUGmUWRqbf6USykGAgiBYoq2YoiaV6V1sm6fsjGDkrjSoVHkWktSU9TCH6QmUbYqaxju7eUmneTcMh97ihW7,true,293321891,293321896,5,1727896524,5469
4,WUyCiLCHZiQ3sncS7QwoheRJearfU9w4stzXS2MjkqLnNxvcrR628sSWiYuXf94s8TKUDNB3NjmzyDLDmbBGFpo,true,293321891,293321896,5,1727896524,5454
8,2dpkKGjfUDYJEzhsqGMi8km8Zxra6C44dTW39ShQYvhrHb1aUhyix33M8UUcGwL2uiKm7Zr2tAdjAeycPE2wFipm,true,293321891,293321896,5,1727896524,5553
1,26iFpAqWfaMwmEMRwFSWMWogFcZEe6KLAC1wyEEnuvGPiaVmoSCVsfNHrgS9Pv4jvoqD4rw25sHVVYLLQ7vdSjJ4,true,293321893,293321896,3,1727896525,5479
0,56tLnvxwbex6CFBQcbhtFiREgCTmQLJ2d6Zef8efBJb2f5rdEDSDMZ3hLZzkAvo2X7b6aoZ2B7jytaFJwTJ3YJt2,true,293321893,293321896,3,1727896525,5623
7,LH73Vd8NrHG8ajQY5gfoDdmnfpZrco66MmZg4GpcBNenDn9RDc9TxEAu9yPf8TcHdGRm1iE2S6kHcmdJoioqpsX,true,293321894,293321896,2,1727896525,5424
6,5dT7F9cjyXySBLJJDrcCkLeCS4GgtyHfkeMgKJ82o5XLSywnEVyPm23YZQN7PPQNPrva74pxSknVbd3p9jECW5tM,true,293321894,293321896,2,1727896525,5573
9,SdVS9jmHLKnscJUoKRehSAErxbqFaKrFmw2FLSCQH9U8oJLRGZLoViJAzTXtFpUYzHArJUeVkNQkiWgAsWfHhsP,true,293321897,293321900,3,1727896526,5485
10,26PS7xgXyj6xek7GRjc4zez9pFFWxTf3VWEtVaHJ9XRVK5emRTpWZpZBPiBybb6yU8jtCJ9KriNKJZEK9UHUVC8M,true,293321915,293321916,1,1727896535,5299
15,3QtQRvzqL7w1iQEkS8esugYrBFGkUsnjycsDs9sR6K5hYX1A3LCRgDYeSYxfUGZZ2SDAHtuhjMYPefANDv5CKyqC,true,293321915,293321916,1,1727896535,5452
14,5wkePBPKuQVtPac2hqTAC5q14tR5FVryvLkN1UbFFqFZb48Gv9zGkKcGsXjQ56AxjCU7BfR7LYZHJx1RdiE22Pi7,true,293321915,293321916,1,1727896535,5551
12,4AP9b5iRRySjQ12epciCvTwCYZ7g8PCKsSo81gBU17YZ5m1DKvHPvqBW1P9A9VGkDf8GLjtfrLZHXf7ijs9LmuKT,true,293321915,293321916,1,1727896535,5535
18,9GfEufYR5fTjPE167thfsLLohaF9Q5tuBHb2pCtnFB2rRA4wdYcaA1juyneRx7fQHiEFiPiVEaQxchREMF9iMEa,true,293321915,293321916,1,1727896535,5655
19,2YypE8D4G8NfBh6K1UuwXJDjScPhwZGhHA6qCv69UNyrJ8cf8JWCiGAaqkDzgZgC49p9f1dUjhBx2DeZz5Zrrdk2,true,293321915,293321916,1,1727896535,5179
13,sjDFE2gkfnhA1gC9iLfbg8KZww3gJGZvuXum6JRpovN84LrhaitGAnFLk3wyLKoxwbK7RuPZcL1cZcs3zo9Tv9m,true,293321916,293321920,4,1727896536,5202
11,3sfhqyjTQJis9wVyXLyjH56ENdhWfMNHhibJ6e3dYUe48FgFDMny2Q8fff5ZYQaYDG7Nn3fs7hX8hko6u6XJaMzK,true,293321916,293321920,4,1727896536,5276
16,63wSRd1MP47KryLe5b1yjyyz3H97r9idyCHHWVq8MCqk93DSiMpDo9CnNd93mEPx2rQKMt1M9TNZF6AzSNYprqei,true,293321915,293321920,5,1727896536,5465
17,2F38hggHejA6P33TT2cQ53Gwr9mMz3dDA49gwwq5SB5LTjbsGUFRJa4cyoMvMKRYma6KrsFfdQHJMdiMxLYJoSCX,true,293321916,293321920,4,1727896536,5469
29,58HRymaBaR7vpzDaiAMqFLhvivvvo6yiWK2vtN6zDH1kMXsBobzNXbV8qFrN8ocEcMapduhAta818yEmgj7zMPsq,true,293321939,293321940,1,1727896545,5225
27,5p98fiWtz4LRcVbKe77BtGjWZwTqZuFSAHzozncpMPh8KzpWNZ3x8ajJwyvDCTeXk2qnuPBD7y3pWFa5r4YkmXjc,true,293321939,293321944,5,1727896545,5207
22,2F8sxEUvhvNR9c7aSe5GUXcgxXGrF6742timisyfjxRXRLsKdgdVKAnCDiWiUtTNJpyS3ZpZCA3ppX4E7XsZvetw,true,293321939,293321944,5,1727896545,5285
25,4xXzCvzyEB2VMReZ6PevaqsJ6Zf6yrAhp2a69c6g37Utqpi12wJ6EgXd4aZN4Kg1xNUjkKHhobKzvDYcDKVFXBEe,true,293321939,293321944,5,1727896545,5464
26,28P9pXcxQsPUA4kQGLTa9c4UedH9RvDMryTEWshzMjZ3b11J8eCCBSMk5iNm2U52LjhA5Nr6WRoaE9GSHmaMJSzD,true,293321939,293321940,1,1727896545,5364
21,323fZwz4s7HRj2qgk3GouL8ANNosucQQG3tRnzdDq5asxqVc5aWzyyTGGZsNNKxBH9eqj4mt8qGodm5EWtvFSWbT,true,293321932,293321940,8,1727896545,5554
23,4ymMrhvpa1YLbwbygdR8rxujDg3fgoBDGyTXANjmXKT2rYRwBYX88f3GCrkgpJVzjcmx3v6hDPeXKd2ctdG88CmS,true,293321939,293321944,5,1727896545,5269
24,4mSynZCWKy1A7MHJxzc1s2WdFr3Z1CKQKG6t1AnPZuj8wvT1E2mZ5gTqdiMPc5iuKt5hWqyEsnqJYpU985B5QB5,true,293321939,293321945,6,1727896545,5466
20,4iPi9NxWSYRGiHub8wkNTqQnkNMGkE8ukUfEAtzrk5sLRzzKKkvcgPvtU1uc7ao71GmhyPDn4BrJrwAco45uECgV,true,293321941,293321944,3,1727896546,5198
28,4mSynZCWKy1A7MHJxzc1s2WdFr3Z1CKQKG6t1AnPZuj8wvT1E2mZ5gTqdiMPc5iuKt5hWqyEsnqJYpU985B5QB5,true,293321941,293321945,4,1727896546,5580
39,3Xwo6dT5mbwsGAb5UPMJA92Me3wmpaFPz5JmM1tRWt7hn3st7DWfg9K6CkAY2dVQnU3V9E65dyCFEuMk4iShg3pX,true,293321959,293321960,1,1727896556,5475
38,258ea147gU9Bhkby4YvSoyibDuAn6DYVz1HPSRngzYSVyqYYJFFLcj33KdC83y5yYjJYW2jurRYG7cKvcuMmZfJW,true,293321959,293321962,3,1727896556,5361
34,4dyhT6rhECovDEpXm5iKwrdjUfB4xWuAyxGMg5tM7Vj9NoUCurxT2dVGC491Ki5LnZg21xCgTCAxJUyE4aa96mKV,true,293321960,293321962,2,1727896556,5212
33,dD3hfVJZFw3HnCkwQHtBv95LqLW4oWpzayj91BPBntutqJhG68k8qBZeAMF2ib5eVDEdwZEg2TCvZXyuTFbAJ9B,true,293321959,293321960,1,1727896556,5531
37,4KYHw9KrGSqeTw18iwjkGfP3AP6khMtbYYVmXqRgrrsTDkwLUXgNS6V5t4nyAbzqn9WMBZ8GX6Vku73R9fxXKBPH,true,293321960,293321962,2,1727896556,5282
35,639Ns2NZrSRscYd3bbDiDo1DaUq1N58epVERdczQf5brQuAKeQQs9XH9PARrJhd1PDFhAn4jspYxoh3nBeLDgQHz,true,293321959,293321962,3,1727896556,5552
36,5oTfT2wRtuy1cTVm1BTeVZtKaRwwS64xohbcA9CEmMVgDTn7rSFfCwt35csBVAKtZsc87J2eXKaYChkcEv6Drzfe,true,293321960,293321962,2,1727896556,5286
32,5UBLuikt5pm3XnJ7Qp7yP4yuy7YjUfJRPrbrT2ShUG2BQL4DcMAHS9KaQabydA35r4LZtnqo6KGdmCrPRjmnjPU,true,293321959,293321962,3,1727896556,5354
30,2i24rBG1i6NGpUTKo7j9wdaL14DVPytBU6KLPTVitqeQEFg8uTY2te2CvuBGrchXkgz71trYwPEZYZE2jB3nYTNy,true,293321959,293321963,4,1727896556,5454
31,5KgC3NVAVKVb7BsKkuNvKACZJAwhmKV8PYEVDcQBAwx4m6gxc6no4znJLdoe1RC7FS5bugSYmchPnc4Z4V6bgD3K,true,293321959,293321962,3,1727896556,5513
41,pmxsATjhudJYi2XptNw6pKj79yjykAJ4yGmukvuFrJLTovYYQat9S7GdnmzUyoNYkcL9kkphnHZfZJPWonQEMH2,true,293321985,293321988,3,1727896566,5264
42,3F8uTKvSsr3PH7eGgdHTmJTT7JiCqXZ6XdxtyPz6gkc2XPv8aZqwV6FuAKwuzraNBE2xSF8f4C7SpZWnwPLQkgXw,true,293321985,293321988,3,1727896566,5278
44,2NhqHCyMut6Z7t92ombW9CupVa1q7qgUVEjXHSkWVGY5pTToqYafeXcShDF1hK3kyoW2Hbe7Vy2A9j9u1ivjXQr6,true,293321986,293321988,2,1727896566,5278
46,3zJGadfefAv2A9NBoPU9UE47L7xPvjYEbWNrFDZaWL7B8VY2UckuHxwRoXzfsWsLHu2x5McWStepxNnVcmAdRZLN,true,293321985,293321988,3,1727896566,5498
45,5BvEzzFRhybPLgoXfWwrvhCNBvRi6ThJd6VQL5W2867UdPKbzrHXFyx9nTMn5qURT58hp6xQQmQ1cGRY5tbyyFpj,true,293321986,293321988,2,1727896566,5295
49,4YWRmLn48M5mQ4Q8XoV1wUg1keUnAY8thdLo5twfZXtNG7M5TittgDPFhhfDqAF6EyPyePwjnTbJ5kzpiwHuAWB8,true,293321985,293321988,3,1727896566,5580
48,48YfkuZQuELh4ncQR2yYXyTFqUjsJuEk6pAdPoHDi4h91chUgUN4meRpwBcFMtJcnTTv7Lrizzgg7zJmAbc4K39H,true,293321988,293321991,3,1727896568,5267
40,3uErDfNFPvLAdfzGzrn9Q7TBaPjmqNKghoDWA3cEGxgUZUEz1SNmzw4KZCPSuRxAdmDotxwHZUADnGnGLFBppJhA,true,293321988,293321990,2,1727896567,5469
47,3sVKD1pGtemUM2ou4rsiS1DFaDJ4q5ke7K74caST9eAfxzrFkowDGS3mknWsL6wb7mZZnj7Pb9n7F6kiXcNuVG7C,true,293321988,293321991,3,1727896568,5448
43,5sY4YefVsvEJFeTLLtGBoSpwCAV3FtNfsKJgu4uuT77Y5LkxYf9DxUJX6rZMwqaymzekszvsxV6zcyFwdtKtHuTa,true,293321988,293321991,3,1727896568,5517
55,5sLmM9wYnhGdiri5QUr27mEyeF6d46n1wxqRwk9FYJfG4fDwxYk5b8pCfEdWd13ZetrWQ1sFQjZcWYBjmCUSyvRn,true,293322003,293322008,5,1727896577,5190
59,4BCcbFcVtkUtKwXigAHKMdPuYPcYoBTTpDgFjJgYSk7q1cL41S2xzuhQgpanNTLnNfV4ejseiB9MGdQxMiRTQt2q,true,293322003,293322008,5,1727896577,5212
54,5QWkxWtRcgBoY5rbtjz4wBChyYS1djF7KqrBMkinK7cnT2ifxyLVewJDQWrrXtT1X1mVfbqrkaXxU1tNFsgAeTAQ,true,293322003,293322008,5,1727896577,5249
52,5ZNyZxgaNr7ofa1yEq3P11adL66NveCc4E7roE8pN83NW1f9eScFhu91CGaJ9JtjW86Drd3evBj6GyEXuxd9zdda,true,293322005,293322008,3,1727896577,5180
51,4QkDv7R65eQpJD2y6sLaqnt96K2kwmcyc7oYWTPSe7VvPU82Gd7UssA1gPHnEofYTwdzgoCxf24xJJB5BZcsNZFU,true,293322005,293322008,3,1727896577,5191
53,2H36pCooxrY8VVWvGNwkuWuu1nn3Tr9o9zCdpU4s2oXVhVfJbqB4eEdtEqpLxDkrw5cXHSvEoozmXKuKcKWEmi7K,true,293322005,293322008,3,1727896577,5198
58,ZZ95j9NNUfesFtdGxDMroC1KrHWmut9wSJBVVQtVmjMCS89xq33pkbN9NtsgCRCAN7gncj1KvCWNhKeXwR87PmN,true,293322003,293322006,3,1727896577,5656
57,5eh7b2HDE473FoW2WvbiWGPTytREEYqnFEjXqr8hEkEHFKKBxX4Rt55xx3kYsBgGWincuYzqHJ4nGDzQuxjbY15f,true,293322005,293322008,3,1727896577,5408
56,2N3GfVfn6gr4fjo5cZ3qfKXHDa6R3qxMY1GuDDAPpWqcEmMP6cfSRnD8RABn8gsBD31JziD1VNUBEHUysYdiVSi8,true,293322005,293322008,3,1727896577,5446
50,3o1Kdi7mHw25ih8TzAJAVwBHZEbV4qrd2Mnr5TZAdf9qEpE9cCgHR45TRASjtMF7EQPswVaUQ1uzY4jH4gSBGZWZ,true,293322005,293322008,3,1727896577,5498
62,41vxJ3H7ndewyV7peCThJLoXxKpRH8o3qtekeAbqcJrnWMyWay1RirLe8ai27dhwCSQXwZW4e15h33weQRsekVnP,true,293322029,293322033,4,1727896587,5203
65,4DUrh4BfDoUaqZrybgj5UCtmcwrtwyQZNkgVwndyyrc2Eqwxsz5x8GAadSjPXWQkBvixeN7SGKGaijF5eTu2uT8R,true,293322029,293322032,3,1727896587,5199
67,4PbEHCFK9AYmeJjmDKXhAamPSAW1SfAehjyPtHtr4JSofNkciXuvVGy5vnUk14jj6niMoszSFGxUU531zwpRZ2cU,true,293322029,293322034,5,1727896587,5228
64,WvpaVxgLhRMKgPLpaF3jbE1SqZCcCHpuPyL7KMr4qzEXU7Y9scfFHfTdGwFBjtmBSnKHud83441pWdhwy7whDuk,true,293322029,293322034,5,1727896587,5247
66,2Wr9rgsGnKdEcm8VJessCVkVS3waa9fUYVpR9Wh3YjP9NVBdVhsgh2esYXWP6ky4JbJxdQ6iKoFouYbbgkbm293K,true,293322029,293322034,5,1727896587,5458
69,5NFx4c73hbQmqRL1jWdPLELL9KaKj7mVv6LBXn938RHkfPPsbd4evdzfGXfczBf9XGXyXEUjMMdKoELARh3JpppZ,true,293322031,293322032,1,1727896588,5277
68,2Y8jvsQ7Mkz4svCCYGRwmsa49ogdnSHRFAkzRB2qvGAUuoJXTh9W3qp1hfUTVVa4Vde4MTEqxrYSXy4W7kY1vd3V,true,293322031,293322034,3,1727896588,5198
60,3aWhozHUTLUuVyZg77kWM1jnwQt8jscUda9TPEc9zzuaKtshU95VFt9tHwukUt4tYsKAQGRug2KDVzJkF2EtBpQF,true,293322031,293322032,1,1727896588,5620
63,fwUput5qWnXqx4dDPUtvuJ36N1XXk9ZDwwudCW9AjCssJuMcWygBzSfm6TubbTs7qnkh9VAHh3REYHAFR5UbEpA,true,293322031,293322032,1,1727896589,5423
61,3FQMgWTL4pf4spJkzEN2xRkbMPf6iF6ULsDPqKhCCE6gq7qcGQKHHVKoUBbmFKjX8S5VzMmsYqf262eYLtvoLNkT,true,293322031,293322033,2,1727896588,5496
72,4xir8JNLF9TSv6baWCRYk2THgj5Tsjz3diKZZNkW7L2TgTLHgyxJZkBgjLF2W896nedSKAfgmxEz5wut59ExQpB7,true,293322051,293322055,4,1727896598,5193
77,5bYg4U8HncW8LV1mwqMsuQG4FkZnMeHHYRu9QTrif2iaU3D7W8WJnHTGTyrT4qsyKXGkZas6o4swMdV5WWSbqm4p,true,293322051,293322055,4,1727896598,5246
73,3r44zkRFuSHsy37HuWw6Bn66TJdv4XTeW84DauvHtmrc73abTCmJu1xsnZKWVhPBKUQamfgu1KqdsUHDfwnGccEb,true,293322052,293322055,3,1727896598,5269
75,i4dmcvufi9kKMHGGExEYRm6wAQG8uLgTaFpNLi5Qvd9ieNkgbCZ6tYAbPabMnWQsYqDGhmBrtq92JPbNbXdmmEC,true,293322052,293322055,3,1727896598,5192
71,4huJPEowtfKYKajfTiJMkc2EMWGQqLrFmLTRWLcxuvkxBLDEisWbexx8iAfPkir1hhWM6UD9FwzoUMknm69VK8FK,true,293322051,293322055,4,1727896598,5423
74,2Rd8CnuViP67jPb7g71hBYmG8EbW29K4tDXZQkagMSsfGYVjkiQQbRxtDazorcGwxZT3wYvnqvbmksYXJ2WmHQxo,true,293322052,293322055,3,1727896598,5284
78,5v2WLHoGraJU9enFQNGFPHb4DC1NfyMbgPPBGURi5KjHArX2HpUfXeZApypJiY7LBPE3fAmmCduu5kinK6FpfWA7,true,293322052,293322055,3,1727896598,5184
79,2i1NU29E2PKd5Vc8QHsVJ2wSD8GtGxKwra3nF3Tw1AaLkuV6F4RTmH4roMqo56nrFto2B4MiJf6nr1n4AdhVMw5d,true,293322052,293322055,3,1727896598,5288
70,AxtVon8ADtmsQcbqHQjdxAQkSJR5FbGTxXAHRWV2Vu6vAVyC8MCTvsjHM5XUXxRvH8Tw9DrMntFeNE4DrEsdP4i,true,293322052,293322055,3,1727896598,5495
76,45sa1j9gJRTr7qjtf3sPcFZWFZpq1ALfBKMnBUasg3k9wwdfuBSLJemU3hTDz3bFFGZ2cSwHj9akH5spksxEhHL3,true,293322052,293322055,3,1727896598,5505
85,32aFxBTVZ5nV2bKhBDGDuSpj3L8e25WfTkVmY9pg7x13wPGkGEEYFXkKauCXE6m63zMGvPNHLvKZpcp2PFBKx97R,true,293322074,293322078,4,1727896608,5146
87,8FLcjKMVRjeu8CaKBEDLuUyxZQJpyfcfoaiFs6B5Qo1tVAQZfqsLWxCmx5aSaz4dBb47o1vdLG5GJ29nhdDh5x6,true,293322074,293322077,3,1727896608,5271
84,nrzWbwpdWVMcdVAEatVDbeAaZAimYzgPPMkZT6KQf2ymKUgyj8GFUJiVAdG4QVPsHCwVNCQ3n7YfDhEPyoL26Ak,true,293322074,293322079,5,1727896608,5237
83,5uhizeJRpaxACnVNqoD5JfJL52ogP1kghoYg289QWxFzCNds4b9tacVtZnzxoBJwDKDduaskTcTyE2iq3GQP7zGr,true,293322074,293322080,6,1727896608,5391
88,5L6u8auBhX8s5GtGdwC5b6BLrmTR3UYXX4yZF9EyPLkKb7QbZjVH2waCy3NEz9zbWqG7McRzUU9iayHcJ2FVhjMQ,true,293322074,293322077,3,1727896608,5582
82,3mXTN8dyuVDWd2pCr4gw79gxmomtkf8EX9aQw86qjRcVBMLAwU3SUNqAzQTVyhnnkmsoMLeRzKGpd3Vxch3iUjGw,true,293322074,293322078,4,1727896608,5549
86,4fthVQSen9CTGUx2hkRziAhEfJxAKMWSqRwJqW4NHRSSqoHKE9Qu7yiZMxeAEwn4EKkgFyqE5nUCHwKgvgYvtf4U,true,293322074,293322079,5,1727896608,5570
80,5hZM56mm2BwtCZ3op5PZ8KAKQWXvih3xDv8MTKrqR5dhMPTyRi7hn1pyvC76FYYBrVuvLZi8sa8HHZWp7nRa1hA7,true,293322076,293322079,3,1727896610,5148
81,4xAbLm2BJULenauckpsiSmc9LJmWWQf4irbqVHvwinY2topE8L4pKQZNGQJeRZ6fk8jVtrGAFC49jWVbZVXcUB7M,true,293322076,293322079,3,1727896610,5227
89,DqNbuVywFRYwh9K7a51S93wpndy3q3Jw48dLEzds2czcw9FY5YjojSVn8ey8seNaNQ32VuZ21R2JRT7t8ShB9c9,true,293322076,293322080,4,1727896610,5398
91,3PdZkhG4jPgTmYS9aabaG84S9J5euwMYBm4JW8jG8iKo1itLXR9QwcZ5jhmLJwtJJNs1H75uzoFwsM2UxDxK8TFM,true,293322096,293322102,6,1727896619,5195
95,y44JykA2pMh9aVextoQZ5hVoQPFB4Ni9bWXb2iAk7Z6jGKnTbQJkiaedcRfmeJD77GxdRCYUYN5JQVw11AGkKdD,true,293322096,293322102,6,1727896619,5201
99,4nJzqpvrGjtYR6upfWHGDAoh5fTGUqCRSvoEVVfMFV7nw72DQuX2kWadLVByESECBFVX6bfQ642LNLiNeZoYhZh6,true,293322096,293322104,8,1727896619,5196
98,4jko3A7Ne3N1P7ycrT5yz4rifQUZKTULt5ypwDf2QH9FurZQvqjAGUgxT7NoyY42bJjkUR5A5sooMqE76RoxBkCz,true,293322096,293322102,6,1727896619,5481
93,3hqxsM6PP7jQJvb7kXqnEewDirDxMp4LTEULuBFw87LjUmfAeiT2bCMkjpYdUktgntNwsp1xkEbBwpQa9fP2bj7W,true,293322096,293322102,6,1727896619,5533
90,4NNA5ru7a2XcW1Wxk7BXPT1Q1PpiRCY6U63hcMJ3JUkXv2NGaF3szghcax8M3znHMKk9W3WwBEmdsPLkb1Pib4m4,true,293322096,293322102,6,1727896619,5490
96,JJzAhsYBYe7PfBmzvFH3ThNi8UWjaT1L5VK9coidQjef9rsQGK4FaSnuReRgrXiKWyKFBMTu2MSBYjcXkQhxJe3,true,293322097,293322104,7,1727896619,5271
97,62FMGgTAUAxLJzToRj3sH79n3f8EPdt2gw4AmiDwy5ZXMEvTScQ4qW7nucPDPHpGth8TKK8cNtJYJy4QRLLaYZTV,true,293322099,293322104,5,1727896620,5170
94,4M7KxogGJzQVVJehbsbW7VLd84xVnhYvJ22jCUDza8Jm62KuCT7yMK9Bc2xKPeuFjgk9npze8kohcxE9vnLABULt,true,293322099,293322104,5,1727896620,5186
92,39zPzEaekZTCd8QZKW5iLM5eGESRbdKMSrbd2PTJq3C4YjPMA3ViizYVYNyH5fvkCMWgv1JrgEK3csP5oRkRJXWs,true,293322099,293322104,5,1727896620,5550
105,5vKxHE5pXfYJJzdQjQ17Mn5RHpmSNPQgJ8E3otit1QUEFUBdjV5P2yNoVsq96QvGFhVkVo5r6UpANHRsbZKCC1Y,true,293322119,293322125,6,1727896629,5168
101,3x4VfDQVW272WiNcdRMwJ2ysR39v3YTQrvSu3nxoLEmCua3ktcmKT7NZSBEZrUvNWnCbtbcxJjptBj1Mhk3kqhw3,true,293322119,293322126,7,1727896629,5291
103,21iPXAvaDeoUWmBXLkiqHkX2gncDYxJNABi2hozRC9gBm9YmrVHAUZhBfSkosoD1UbjKyUBWcwPcYphHZKjDQ6Ko,true,293322119,293322125,6,1727896629,5277
104,4Us5SpQRayWmvdRsyAyPkdeamNH9aSjvs4GExNHfszUdPowP4C1JD82GvTiJ1goMgU9JJ96hvJt7945iZo4TciDU,true,293322119,293322124,5,1727896629,5204
100,6uUg3GVTUowFaKnDcWMs3eKmQzT33efMUfzaTLnueufieDijvF7qF8aPsobD6BXG1mNpxxuZ8iJ1FnWADGoHVpu,true,293322119,293322125,6,1727896629,5335
102,4tPPxTaJKaKa8zCuyksgLRDaBp86D2aN2TCqtEXjEB9ieftmqZ8ExMvixv8ZW4GK6PjCmBqujkGLRPBBVvAnWetM,true,293322119,293322125,6,1727896629,5307
106,52bQycjG4Ge3nmibnsaUiRHo9XwhCdBXbsVwmsFyiWawWQM9wxaStuxiY2EcuASejVidSLpYJTJjrmkFJasLVkVD,true,293322119,293322124,5,1727896629,5463
108,4umAWkWtQaKw9BNq7S8BhVvaX2CyLbe87XykbKJqWe9XmmU256mhXhjC84tdPzcmc8Z9ANZwZHyV1eT9ex5X35j1,true,293322119,293322125,6,1727896629,5215
107,nMyLFAeDATjSXfwS6K1sKvUKidQEsmwjtXCn3etF56XpvwdZfJctixKQBzmiBZfo2WuAJBwdYCdAx3LqGHdt9qB,true,293322119,293322124,5,1727896629,5460
109,44banzeX3BNJpMgU8H7Z1rHT25h8K5Tu422U5oSv8PPMV1EDVJTHU3fJicuT559n5sXtZjaPNbSk9QTAyMeC6366,true,293322121,293322127,6,1727896630,5276
114,3EHKY5uvRcP4DgVhLX96bWDCRjeUy4jmVpXp6VbJtrfbjBVL6nheWhpZ66VuM5aVVSViUU8o9DuWEKD68Vo7rhYQ,true,293322132,293322147,15,1727896639,5188
116,3LDXH6kjyyyVaD2bB9ZBjbK2RD5Yu3gqmn3Ypp5v1NRi6K5fYVuZWjYEks1BK63FT9f9iN5nvB3fc7gNN1kN9ffi,true,293322132,293322147,15,1727896639,5204
110,33oBri1a44vtrjMB4UQZ3CbNzZA7AyVzgAxJH5qaoqB7DZyWAKsqxRBXB6obueU1BzPE5PLbeC3uVkqTYs7by4EG,true,293322132,293322149,17,1727896639,5205
115,KrQuNBM1STVTtGnZZz55zxaoNEdFXAjPLLqS5Ag8SBxhHbYdzTSi5zRtswxsAA83MuxxnZ6mRMAkmKYBaLPFbjE,true,293322132,293322144,12,1727896639,5201
117,5RyjK7XHiaqUgZhzFFETiB21X6Tr1mstcZqacbYXS3njmHQWUYJb6E8Tsp1RWwMzCT2h2aJSGKRfnFiiwnY6KxVo,true,293322132,293322149,17,1727896639,5230
118,3z7hcsuiUBRzatccBnnfg6QhYnwRJYcM2PqEMDhvxfjxUQDovi5yScjMz8Lz9CYY59pioCFy82S3Nvz9ipC4qjwN,true,293322132,293322144,12,1727896639,5260
113,2b49JbrP4sgbAKBL2pPwHi7reB6Nwkrh8Jc4tkv3u4SnpeKMEwoMuYLPMH8tN9Vp6BtCd6T2b1ipmDQbdvg3Zece,true,293322132,293322149,17,1727896639,5376
111,2fscLv5pp9ZDCAFoLAtRPeSmVdTY4X1vjncHa13CExsemBkTVSqWJVDw3AX2tLYec4S26HHdoVT7tCE6z66irYex,true,293322145,293322144,18446744073709551615,1727896640,5186
119,2rVSccN25gwwr4gk3Mffkd6kFuS6ZoN54gAemEhRXB9qp5f9Na3fe3ZN85iaFaCjmapV2nmuX2AAFyvYVXSdxFh3,true,293322145,293322146,1,1727896641,5256
112,2MgpsYz8a2f2rV4EudmzHn4fAM5dJMwFruGN8GH4H5HH99NCNnWKw9ccD4iBZ8p4a18juXW4JTYp5J9ozr8WQH6T,true,293322145,293322144,18446744073709551615,1727896641,5507
120,478JdtvQKPJxSVM2r3ZBDYfRXcM8zUTh3M1WcRqCQYHbkY5XtNhFsusjgwzhEQPbewmX5CPB8PiExqDgbeaYxto8,true,293322163,293322165,2,1727896650,5204
122,42Mietjfs677tEQSri6o8Cn2BJw7dkw5JP7zrhgWmwKFC3M3pncNEhjpEzqkupypEZ3gbQg9vjYWiDgUx1vLUvjD,true,293322163,293322165,2,1727896650,5236
127,29dfhe2r5h32Ge7Lt7HMZi5U8LeQrMKfMSEjahmFScoU8o8TAUyjFrzsn9CZBFVTTSpjRR4FRkcSZyTtWa2Y2FRg,true,293322163,293322165,2,1727896650,5297
129,4pKtANNN7rrr3iVuBQzEm1rq3KTX7tQRgfacnD75ktYUnupDfHz9rs5M28fu69Sue4k9YxJNtGfkV5sJJvyYhYfe,true,293322163,293322165,2,1727896650,5277
126,58ErvfN2pUGzuJTBFVpdZca5UueMsZgMA5z1xziszSUXfdNxnzDgqrGDk2GvyypGNLpPHTmFVZ7JETz24x8GiWm3,true,293322164,293322165,1,1727896650,5155
124,2GSNNNLzPfoziagDzYMVEFpC3VmpozfrDM7gmgr1KzbAqjGonUVyDoGULBGqXXThp9YDUC2trWh4Lm83aqmkRpTW,true,293322164,293322166,2,1727896650,5191
121,5SQUeHko2ENmaxa2pEEv9H6zJPvV7rEMga7hJsTdU8Wbf1utz8ho8Tzeh4FeES2iZgcW2Si6Tss2gifcGsENhLRw,true,293322166,293322169,3,1727896651,5189
125,3DGXZ7epQVWgZG9vvmA1Wa8Q7eJe4YqndEpoE5HcqHmso6KWri4sDFL6tSD5UUV6G3e5ZxP77svgJXgnHC9EERh7,true,293322166,293322169,3,1727896651,5188
123,33ojMuaAd1QVTqqo98qLCt6bnfuyfk6CMGf94mvgZQbXgMHq6bNfCixPReNZUK3ZCwsnEuSqvRchStFsU16wqc3p,true,293322164,293322165,1,1727896650,6662
128,4LiJNkUgXVTtVSnSsCaUnMeAMqoUEyj32PNrL58hhFzwnjQvAEne4A95gcwzmdj2go5TXKqY2wam5g8NKuAtL1wB,true,293322164,293322166,2,1727896650,6704
136,2eY5PMuXCduUjnrRyqEvhAxd2gZ9CkNQv6U9xHQndCde9CH52EYTbSXSM9idSL3zHBUUnrE1oaSChfWQrSVdAsEi,true,293322188,293322191,3,1727896660,5213
135,5hWEoYjYRLqVNpPRyFJRwoqtH5jqSqp7mUoNoUdUHxb2A5qCcbMHEGX6tCFB2QKJF2mmQRg6JUNh2koCVPfmKWhU,true,293322188,293322192,4,1727896660,5171
134,2UHDB7PEM56bekckMhwKdJNGF8z94zEsHd1T7Qtc9vRfbmr1zNBHQTDkyoVdkQqYwmhARhpaG3KCA678hdUtSrPu,true,293322188,293322192,4,1727896660,5204
132,39z4PPSh76xHopeEyPGheHKjwywTQBG42HTKoM5vh4A8KWaa82V4GndKPoB3VHWq1k6mqCvajS7tZuk3eoPXuNwP,true,293322188,293322192,4,1727896660,5196
130,TzrfeQkuYvAAJFxpyhk8SCGuBjacUgSCf72do4kLCxQQ5gJ7ADo2uHFQ7GKW7tbFMwvmoJitdvF9jftjA7pB6uD,true,293322188,293322192,4,1727896660,5323
137,33VVPNGWXJNxUWdGwgyJBeraULgBCFGsqhB2f47DgkTwvPNb2PJbCavtKAYvdCujHB2t6vseGxt1wporcrYSg7V9,true,293322188,293322191,3,1727896660,5453
133,2MXTHr3dP3VuvrFvph9drPfPbNbcst6YMqLe2xMwXteREm8M2GK4Rfn1krJPQoAcCPeT4x17w3zjDrveA5NAJf4g,true,293322189,293322192,3,1727896660,5283
138,3mMvXvmx12vSBjj2kLu2Vm6N6YrKrQPzbxLAtSkbgZmmFrXf9N2rxL36URaFqwC8TSMkK3uDSRnij2TZTK7Afq7o,true,293322189,293322192,3,1727896661,5279
139,3mRE59MSwt5BJTuKRSWJo8A4Fb8eFcYwKgLVCDuETtEyBEDktPofwRTMSKrDs6xr4pu8Z29sZhJS4uSwQFkRERKi,true,293322188,293322192,4,1727896660,5445
131,3WK1ZmnKyrLQxAhFMupgzjKrgkapjQBBPeRCoCL8S8LuKLetaaEF1yHcJkVNn4DWXuV93zaBqZPYKWYMZYkhXBXA,true,293322189,293322192,3,1727896660,5473
140,3Jwjz2bZoUdFwEmwPPDz9ffdkbSpSgxwu2M7b3zEMi4CMF8YLxoz7A1kxTtvEyf4Seb6jU1pniKjPnzBhEaPBvWo,true,293322214,293322216,2,1727896671,5208
141,qn4EQxGf5zKoozMdPgWDyMgymCiU73m1fwMA1Cm67GXFdGW9P4hpdNXE9yytrCUxRMjwU8oM92SKsdCfY72QLvv,true,293322214,293322216,2,1727896671,5269
148,4KBrXBRLrKBZ21zUR3uBmrYWG2kiq2WWwTgfqDtTy6vFLiNNp5CynV4wksQfSq8pfhhzGtiVxQ97Ug23QcA3zYbH,true,293322214,293322216,2,1727896671,5273
147,45GJdUMt1G7YzA7UKhv6A5sZvTKiWJeAJbqZZtS3nWE8wFv73S3f2AquYshcMqxGDgpKctxdfPtPcREEeE9cc18F,true,293322215,293322216,1,1727896671,5267
145,2o5Be9RkVyw9AhLHoPTk2TjGzgW1nedXYR577yQNmS3jQhdAwC7dg274ZcHcNsYcr7dtFE7NXzxawqygfhymRnrN,true,293322214,293322216,2,1727896671,5450
144,oST4mQDFHkcWkHK6rfkFn5qEXhw1u9679Ma9SvycXpfxyx1DbfNtV15jzKAUwJJfmfK5kYTT6gxtYzLk5RRE6FY,true,293322214,293322216,2,1727896671,5486
146,53T8W9CR8n19xTVGycigVcEjCTZtX3dJLuZscM9aKede42kp88o5wcCaXKPCTQpXM8PaxQ11M1geYF54a5vbsti6,true,293322217,293322220,3,1727896672,5200
142,2DroLMnirAQ9Tm4brNS2SsTM9rps7q2s1rVVSno7c2xWpe7SB14wMf9gaSuBxguieAfb8ftrUjaDxbCtJ7gtXwAn,true,293322217,293322220,3,1727896672,5296
149,2CY6zzouofxNjvi9BCUamfLCP2Ve9xL6yL8RTPwN2L1pANsZppD7gky6RthvwT1QRetv94rPLTu5FjxnLTctYjvr,true,293322218,293322220,2,1727896672,5191
143,3Gz9Et1BCqZGtq2Uwr7mpuwYAJgfQijJVVcTaDfETWGnF3RQTGh549TkT2jBnFyGYMshgu4b7ay8knrgd2ZH7dyX,true,293322217,293322220,3,1727896672,5523
156,3khGzVCEP84RCYgP7gPUyStXCWWGfvpNMo9smwKLBEbNVc9SNr8iXT7mmVb3fogHDBkdc4nwcixH9crxhzbfJn1d,true,293322239,293322244,5,1727896682,5214
153,XFaRPViDdSLLbGVq1guSXUATgP9VMJCevWashfsDNgcr2h55MakNgBbQP7u3MHJT2XrzLecGwocjmaKXHh8EU8n,true,293322239,293322244,5,1727896682,5200
154,4sCV7TEgpZqLcKiW93kaD2eVzwtbWzA7Su4hS2gd4hYj1GRsXYPmDj1gr1FWc9ssPMeY4Ay4AhchFXRVXSRbURAD,true,293322239,293322244,5,1727896682,5310
157,37D8Hsbygb2pVtwpTkKd3d5WTQpcvhMvvjrshkN7VWhvjvj26dBcDhnMeVSQG6fTTPG9QyhtTcLnVcAvhm7E4RRp,true,293322239,293322244,5,1727896682,5156
158,388VvC8zccds7gFsXUzqtxKQE1kWN4GvoW6muybCKG7auvHdsDXHkMGTpmyQ2Hw1UqGWhW8VjkCHEttstG6YkxFM,true,293322239,293322244,5,1727896682,5285
151,2buEej4aHsKxqha87LFFgCK1TQoFUwWobHRhJoeXtzfBLFKo2VMtAfkdUxQRcjaMLL7EqjKVEyEmJji6WCH8RnUk,true,293322239,293322244,5,1727896682,5140
159,5wYbJNDNoLkJecFpvKBsEH5gHv7Br8wZwZUV8zAFGLqzcCDpnVbXUkdCLKrX9bicsHYEK997h66cF7z5sjR8wqbt,true,293322239,293322244,5,1727896682,5374
152,2VRbw87Kx7xWDEXoQEFoQcDwzkNudEAmDJhtQWuhihC7j5jrFFeseJLSYH5BXYAcAphbqipNbBhv5dEFgz4NyYTL,true,293322239,293322244,5,1727896682,5443
155,4KWoNeNobBhbmGzt25k9oFkuzTLkinLjFAXyTRqRz32AQScnhMKCitzM1UVdK6Y5yVx9JSsyHKXB7gQqA5T1fHAG,true,293322239,293322244,5,1727896682,5430
150,cfJhi4LKZqwtsVP7VBvUnvH2VsoufQqA9J1YE6dAmALy2sVbVJNm5dvyPaj12mkmoijSUNuWzQngmBmCM2di9mj,true,293322240,293322244,4,1727896682,5140
