id,txn_id,status,get_slot,landed_slot,slot_delta,time_at_txn_sent,time_taken_processed
2,uwFSRDYdwqyftvYmBqSDoBvvmfoRAM4FQvvQAdQXmzr5pheF9NiVonVTQsMgL5GuPGSmtadcJJAFWyygYMRyscB,true,293321891,293321896,5,1727896524,5496
4,2ywjHEeHFEnkz8bcwnXx7fPsogj5sqB5Eh5np6Y4UUURA6UQYeL5TAWRHeJTymv1UXhzAAXvXpbkKWfGRAhp16r5,true,293321891,293321896,5,1727896524,5503
6,cbiTLgddFhcqqzPrkZTPNGrTy41JSjYHuC7x1AnqfvLurgsZ4naXvybH4JEoX8XdhtYYjT4L7iH7vat6DxV4HCk,true,293321891,293321896,5,1727896524,5504
3,42KAQRNCFeZdFEG1EeYB1QyAqJbcNCFEGHxgdAkopS2JUHJ4JbrCbCaWpCWRQYytMmEyjrNn4XYpVJkF5BVSBM1H,true,293321891,293321896,5,1727896524,5515
1,5mmTApmVLXt2tH8NQ2pRfotGcDtVB5ozedo7aAaVr7tfhyaLvUz5ySh73RY16kGcd7uAGDYV6Ch2yDaM5K1Cbd7Z,true,293321891,293321896,5,1727896524,5547
7,3VUdQ1yckeq2ZsQtJXcQagU2Fza3C3e49KGf59U2caiT6qCAspxLbxnA19yTkjHD6Y5KuDZEUavoud3aJq3iKhwE,true,293321891,293321896,5,1727896524,5573
8,3WUE5uaupdpxDJ8otwkQZpQeQwpKspPkADtT4LTwB77jUCSQjpL6b5A3RfdHrjQvQ2inXoo12gzMS4VPqa7hM49i,true,293321891,293321896,5,1727896524,5578
0,5etWTq1HKrFbggJGKGbTuk7opnUzJRAq2FZBekEpqxj8M8e7eYd7ALcoBvPSaF9spHxZwj5ekGPE5ia7CpyfwoGS,true,293321891,293321896,5,1727896524,5605
5,49crDGEmBmCmuWTEDg7DTYaBYJ3JzSLNjYDxnn3DhHkt7uZ2N3KCXkmdYBxa3eSRY5qDX92sUFULXWpGbDAbAVqE,true,293321891,293321896,5,1727896524,5652
9,BpU1khJEWicae4YXEjBsuRCemCLCSZ3RShD8xsoawq4W4Gu57rgRE2q46iiCm1S5sZh28ZJR3BN19SFGtjbvEQG,true,293321891,293321896,5,1727896524,5667
16,5Z2zfLNiKNe1CEo1fK23DkMuPvmGQcCQdBQj7qXAgN2fBRMtcoVn4sad8ZpbWqVdsYkNFfgg13cEoLsCJULw42TF,true,293321914,293321916,2,1727896534,5167
12,2FGo7XnJwvFA1AqChj7GDCMDzRfeXzh6RNyNVeA2gPt1mG6CY2gWvwPuRepasFV73WJrgrRsv43dUMn5kAYMmkb9,true,293321914,293321916,2,1727896534,5362
11,2dBQz9KFpsAjXXYuyPdJwNHhPh8MC8w84WKSmmHnNBDuQHAno895gvn5Qrc7ADcB9xRcptmv2wxRKD2bXD3q9WBm,true,293321914,293321916,2,1727896535,5416
17,4YRYZszaPjtsbGQg7T2cVWHqR3wDNcXHLoDUeuijTkmvbJ8KpPaMgvMN1Y6qNTpk4SXB2eK9eVZN1VsK6Dspq5Uo,true,293321914,293321916,2,1727896535,5437
15,4DqbduaM2aFM1rJCsUDWjv5Wz6uDRRKCkFvjJjJWQ3K8Khqxh2DD7fkshcSMw2Cyjs1syPpMqgcgVt2rKj37GX74,true,293321914,293321916,2,1727896535,5445
18,24u6XsfoGaa8HLTpCJRGfiZ9EkGqmdhn9AyiBXpcwTvYahT6hi2hBE6pK5t7gJidX7rTvzNgweAbhxPsoJEuBkpc,true,293321914,293321916,2,1727896535,5465
13,4p1wWKoPD83gYcfvyohQgoiHmy27DvqahVLo7PhWgMjXiJpZmaAtSrQEG8WoQyEnnG6btE2msbrJngV4NxzDBLvh,true,293321914,293321916,2,1727896535,5476
19,37LHWR4TtwcyuoYXY7kamBch4aY3RkW8HL7QPTtHbwctkdLhrADAvbmS4Zpn5UhD5sJNv4WxYr91d3iXoQBFZiBa,true,293321914,293321916,2,1727896535,5503
14,3S9oL4cKQ3AhLbQR3gutvaGcCoQi7hNF5V25kATC45GSav6LKHBKWMWAE6K5AnBCdK8bNxs9185QmqRocJb99fXd,true,293321914,293321916,2,1727896535,5491
10,15qhidoeoAp9W3ptThPQ7Bb8dGquv3z3oHn9r41NteGt3yQgzkm63CNrzM8epTye4kKPqPVcc8PnMgFPmuXTRrQ,true,293321914,293321916,2,1727896535,5540
22,43ErcaE9U8VTexJZdHPK6gnYBfQ9T9E2GhiT3QfrMXseyh4BrVTzGD4eSug7YNe844cr8g3fvGU5FjVycTEDWrSF,true,293321932,293321940,8,1727896545,5185
25,3gQD9k83wTFkaVFTPNudLn4EV1AfruZfAsHP7sn2X4PsJQ5Ubte6kBbTaz3iURisznZBMSYybV16p8bmWWEnzjaN,true,293321932,293321940,8,1727896545,5209
21,56WcZa1YXmSiBZ1qRTPLSfixegx9ijt2VEnigKTsZaGx1LrwFjDceWcSDw4GBEuLVyVKCpoJesaASkCjvzaTg4M2,true,293321932,293321940,8,1727896545,5242
24,3miMJehASGR5RfLjiLAtH1am4SX5gZXHFRG4JgxcfMSur9RwGQ5kyBZiKm6qd35gLPoyXXAzoSeAYH7DYDut2nFs,true,293321932,293321940,8,1727896545,5427
26,5gRpFbGHpEEs1v2kRwPR6NgsrERZuZLyAZEyuvfXcgUdwfbgFRvghUBJ2hkSK2UiSiU7SVDWGjHkuk2Es2V33UTo,true,293321938,293321940,2,1727896545,5466
23,2rjGq4gWgVSHfwPeijiznG4mSbyfyfXsFz3YoAbuyGqnbZwUq4jqdQb3LqASwLigH4VtU6TDrPEFzSusfyp7jEuU,true,293321932,293321940,8,1727896545,5488
20,ZdXB3HVHFWBhpQktWhhXWcf1H1b8pyGTak6h4cuJ4VkwQwgGFFAuHqE7txDgJezok6UZdT2Nfh35V9ahfWrvyAj,true,293321938,293321940,2,1727896545,5564
29,2zhamkJYmW7V5y7d1U1CXdt1QjfR1d88HrKJNgndpNYdKAMgoPqGegmGJSEs5XhzypJU5Y2GTGBmgWJZPFo3WYN3,true,293321932,293321940,8,1727896545,5530
27,nE6Wqj8MSM1g1iKrGfyn26jhyw1jC2NLdfdq8RgzZQStthYiBqS6vw61m4VTSnUWysQHyYLe2FNZQhDXEwZpCAX,true,293321932,293321940,8,1727896545,5568
28,4M7Uo1Hf6S6kUa8vJH53E2Y5fA9gdwT3ekXMtb7XjNaxPbSDP5GiwhEq5F56oPMoz43vXRLJ2wp7Kbd9qGMxmmUo,true,293321939,293321940,1,1727896545,5548
36,5T2rLrP7X2BYKnai2ZwULnoWawQGhX7hHChae86zoFkFrbnKeC1e8FPjFyLZaE7MXj1DDq1oq7V9s67U3gj6afvq,true,293321959,293321962,3,1727896556,5202
30,3RZbe2mDdbt3GWkn6A9MSPfj2wMFQ2efgqWR1JnGLqDHuQF23AXYn8Vk7NQvyEb9Wr1cgsTChb5BHbfC4iK1kwfM,true,293321959,293321962,3,1727896556,5309
37,3SwbnV47LQwbxbn5HpJ7zcSUsygN2XK4Ku6QATMYsUHekdf7QcGfwTVQVAqy9sfJCyErhPomVXbGD9mvRmMM4LEz,true,293321959,293321962,3,1727896556,5310
32,5RdCVuffxW8DccwJQhUxUfSbGuEsKPZHkZEqUmKCJzNnKccRAs1buVdvAVT5LR7N8weTAzALFZN2JhwNgim8gokB,true,293321959,293321964,5,1727896556,5476
34,3JHS6EKLHA25QWVSGG6iL71Pg3WArFuo6iz9Sp7VqdVDJJt2eQj6NaStkDz68LtJYDyQpCFStiUrx72mBHnzssxF,true,293321959,293321961,2,1727896556,5507
35,4p74eSABGzVBiTxtm3CzFpUNjxvnCDWanvxoPb1bYvxYiYDKb4FaRrx3UojeQQ6Gf6w3cf6Lk1TWyrMqgGSA5Lrp,true,293321959,293321963,4,1727896556,5533
33,21tXtTPWDmG9oiPcvgNzxz3E23BDfhnJqq7ktL8fDGvBNVUH1sDqS5GykhS9arb9zXKQBNKCQPFWdXVojwdYaXpF,true,293321959,293321961,2,1727896556,5555
39,67jYtisf13MdQWbMeZFvtPdFkaRaztuc1PR5FimDaQhheosZp4wJHZXTziBMP3f5x9zPZ85u7EQr3KkHeFzX2Cg3,true,293321959,293321963,4,1727896556,5563
38,xhaXSzh7TzYQApQj6j7AJJc3245hFzT5cynwMhdLgTTLmwgJN5nhyNBhv5pggEqtLFidRSChWL1gqjeYb7W8XF4,true,293321959,293321962,3,1727896556,5462
31,2aYcmJjLNHmV8La1upqcpwmWwgtvfU1Xuf3hmysrGAjFgTxH88xkgZmjTpzPF9hEPTBtGb9bfoa74DqyUegP2mPp,true,293321959,293321962,3,1727896556,5558
45,5ULJtTTigYWPjXojnnP6C22JT7uxKeCaUCPH7QvzCMojhEBYfxL6Y2XyzmssbLWtgHp7vCpg6UejWyDj42x9TrVM,true,293321985,293321988,3,1727896566,5197
44,2gd8vtJhEt2hrfwHEoiV79Trud2V6AmyAdevyeekSnXeTw3n3vYaaiAR15Eu794XB8DrqxFodcrpUUcNcXvuyaZ8,true,293321985,293321988,3,1727896566,5212
46,2MrML1PifUixa1XdL1vNjYgDZuJgrpyKBf28GyjnEDJYCeeQg4fdsmC8h9ymMYsF8H81vH4E6MtaceAQ7DXAQ9P4,true,293321985,293321988,3,1727896566,5266
49,5TPXMfY6WpGkSzgoCGd8pk6DSz3moyYq1SganRHEPdzsfab9tFrUD83amRojxnshmVstz9GwXbPXEE51UTgvtCNP,true,293321985,293321988,3,1727896566,5256
40,CMBMnPJfu5dqFiWK7ft8f1TtpaZ8seCBvem7BuD4pkcCBWktStNjwkiaiCaZTTiKjkQSfjfjzddJbRvu3gFgkU3,true,293321985,293321988,3,1727896566,5279
48,5gGZjmLL7FHwrLAC4B9RrMX3KvkM1QSDwyWVb97Tnt3bHd7JbDBntoYorhf4a4oWT3sE9FEVZxpKj2RbMFBrDswK,true,293321985,293321988,3,1727896566,5436
47,hWrZkWDUSN31MP9fSgX8Qd5my1ULYiuMWrxTWKqa6mvaMi3x8BdjRtvuhD7W3BYH1AF33RhaY1aetKx8Wg7ReVu,true,293321985,293321988,3,1727896566,5485
42,42u5viYsY4J5QdgpjeeoNSqJoti9PXjkNQ8QwRhJioHtejCJLerLrzEw8vci7D1xGyyX86Z1R9FrXw2v2e9yrG11,true,293321985,293321988,3,1727896566,5514
41,5uPHrSeF6zqHHGuSV1SC5f9SHGF8UXSmQD2vdvKBAVw9cGWRuEHj5zBBopMaoX2pnBUGYVma7o9F3o6ZPj9AH17Q,true,293321985,293321988,3,1727896566,5534
43,5Ma9Yqb1pTtViTsPykbt7SGUBKaALYbZqe8QoXXjkX5D4CevMGzugbpsNusJxDS8bh7X64euiqzWkULf4cq8QckL,true,293321985,293321988,3,1727896566,5541
56,3yXQVzrVsRsPbWyCt9KXi62vivYKK3xZCeMCAxf9gmB1tERTj1U846sCSxeUPajnmSFi8Utxt1PGUmUNzwJhWthc,true,293322003,293322008,5,1727896577,5177
54,64agbz5XWQdfzie4ZFhgsXgeBbxKXzE875ANEwtxLn42sooTwXqA93NA2gSEEkNcJvUv3HLywJwRxT6ZY2x5DE55,true,293322003,293322008,5,1727896577,5184
55,2MQpgxbvSbhHHJes4jkBuMYXmhjSemdRQ3C54U6dBbWkLYq7icXLYcBNYmUpc4U9Z2cjRXzyzohd83iTs4P9KvDA,true,293322003,293322008,5,1727896577,5199
50,3aGKBCmxDNjGdAQRcSVVs8y2yMnVFckYf81UEpRDL6tFS5H9H2VDegZTqtFmwsroTABM1LvZm9ubfxFB4VHGLUSr,true,293322003,293322007,4,1727896577,5442
57,3rt3HPvBKixMigqsgDeE6LaZiJgiMvrrMiRJCxLEUNmz6fgmMRC4VG3wxDG61k8CiQRu2Fd2maXxKgP43bUZS3Lq,true,293322003,293322008,5,1727896577,5425
51,4dwzJr1eTsY3h19uUsJZ3ndfAzBUapVtrmMfbmesyJWfag4gNJtdMFxvpwQvajAs1bPk7ykM68DHN4NsJugAYQso,true,293322003,293322008,5,1727896577,5431
52,pYDbDoYmqumkUf7go9TZx26TwChBoJzUjvtvRWaDNPAXQV3i9qhSGGvySTza16XubHqYysZ9vbZ8aQnS28G7Htv,true,293322003,293322008,5,1727896577,5493
59,2pTCjT9iBsDMQ8fAUnhAUpkmFyWkuzqYDKCuDmd6qBDCcRJNxrQfVUVWc2VGVzxWSWwdcR2X5ZYwT8JsuCTuaZve,true,293322003,293322008,5,1727896577,5498
58,2GNNWTEXpmTTD6a8Pny7hKYJXxDujrQGdFbhXhhmMMFjttdQo1m7Q3v5tT7Hf6sKUN8RN18BLvWYKtyz1qgt2ZNM,true,293322003,293322008,5,1727896577,5519
53,2FohfBRRyMGRv8ZXWCaVqGsix3GG1dnzbptPVtSzyAuj7hSRjf4YEUepgZ9J8t77wfYNhMFTNpRpjUhh4wczfgd8,true,293322003,293322008,5,1727896577,5571
69,5YxnfLS5zqZRDEbLLyfTuXcPrPRZ5oLqEN9YykGRPkqJn6wNuFbHda67wnzodxnzNHchkyPETTY3vZ1Cr9tR9vx2,true,293322029,293322033,4,1727896587,5205
63,5kKiUQqrubMykZnkAemofExY87KSTD9jFiyy5g6K9tRqNKjd3QUj66LtzubcTKb5nswNNzGuW9mpXMVr2XxGVi3R,true,293322029,293322033,4,1727896587,5263
66,4UGfpBByvnPAwVUKxY3ti2tFkfNNzyVdG81J9eDSYqdVDXx45bmYAruxakdtgd7DXCV7ANBP1Jaf42QbywgDZssF,true,293322029,293322033,4,1727896587,5302
68,5UBu8NPQwrFv4fvZxd1YAkZZzbF99Ek3NAHpLyT2GzUV8HU8he88gS8UN7RfpeBcaDqrEvdvSaJ4q2Ny8CuKxHKy,true,293322029,293322032,3,1727896587,5300
61,4ig5SYHtmF3imvtSPjdzWK2Bdjwy34KPD3Ck6rJsawNAaudkeAHXbkjReQY25Lt45RU5ikuXRVGpNgqBn72qEZgC,true,293322029,293322034,5,1727896587,5404
67,2cw6SowEZWnauFtR6SXXtFg6T57zTKriauhye1ZAsZ6Ta9cTSrRTJyLWp6eEZ5P1ZdHoBfk6aVk7AGrYkKjEVNjR,true,293322029,293322033,4,1727896587,5436
65,3S8XWqFpdo1gHT9j5QGZteyXdYyHk9Z5tRLVkvzgXxMPm4gxWFapY94TYJKwsmoyaKKGknnT4RDtBZtD8MsKEm5G,true,293322029,293322032,3,1727896587,5443
62,4o24SPZmhnYiBR1syD3yajYyDknnDoDqGNbkX6dxFaeiLGi82G69bucr1YbrA9Cs59oj8PphyyD1kGKR63vSuf9A,true,293322029,293322033,4,1727896587,5445
60,46qYxpsAn454ecVr4kraehWF1QwcHVw8yvvxefKG7d59yojndHRm5dGy9s8vcVGURmXYAEJ46MdqapBfKMNJawYJ,true,293322029,293322032,3,1727896587,5414
64,4xMt67Y3WzGNjekmsaBs2t3uEsgxTBgwom78itzCcnxUYWLB7rvfa4JeV8oxwMAkPPwsqgxHYufG7LWL3JCenc3v,true,293322029,293322032,3,1727896587,5638
72,3hqnnEbz9cA49bWi7Ei5fDL6grkRro8wpzwqyoLXvgtThFCdsSQU3YBtGpuWFpMnojckBY4B88zMfzL32QcCm5pc,true,293322051,293322055,4,1727896598,5173
75,3o4ffbuoiKeFZA2Ho2QuhrB1cqFfoHfzNX3ioyjzPNhcVENUdWmx42fxoFMTjoe14Tg57re92y7FP4GfHB7L9JNp,true,293322051,293322055,4,1727896598,5186
76,51yc9HEBFgoyqvNXQijEsxE36m42GCYumk5m3LgzUDCHiPPUCBYDYjMqLy18NSmspZGfhMfgLGsdVYSvBAtArzRx,true,293322051,293322055,4,1727896598,5273
70,24HRTTBWDyzYLdFGzsfpedFz46GQapVSqGQW6hdkRN8L6Qjpbnh84xNThkzv6UENES1Tgtj9stUtpyR88Jecc3UT,true,293322051,293322055,4,1727896598,5264
77,5D4pwLGJAYjSPEzfJjQghSH311AKD7cRxvsCKAmaZzB1RtC9yPo9i9DMZZY3s7MKAncXgfbWmhPAj9v5wg5NbSf2,true,293322051,293322055,4,1727896598,5284
79,63rSL1vDZjAJqnRagYUHYWGn94RZa1rSmjs6QLbQBzcmYBFyQH1rkzKM3FtaPdmdJLppprApY8kgHyMEnf3bgAQU,true,293322051,293322055,4,1727896598,5276
73,7J6omySMmch4BAwfMY7XEPnsYtR3eoLBf6QY4DFte4qvALqhcg2yLKM4RqJbh8PQaVDtc1iHzYu8DDKx8YkAP1w,true,293322051,293322055,4,1727896598,5420
71,HRHuRhEc2z1jkkCHwyoEx3eqWcpXSwGV3Z7wYD7BC4aqSPQ2disMk5ZX4XaGeN2fjtuK1nPQRwe92QA9toD9ert,true,293322051,293322055,4,1727896598,5467
74,2Cg3nzwVjthn9CUA6gZPUayTkRXhEffYyrkh7csPG1FWSSn35S7wHYJEMt2pGdYhhtSY364tCJzkQ1xS5NazFXPz,true,293322051,293322055,4,1727896598,5489
78,5eB3ZttQoPgiKWxvyZM4Qsx3WiCxmAUHUjH1m1cKcrLrCXkM6uroueuHitDmRVqJ99hg8VCLZdVQMN937cLX3TM7,true,293322051,293322055,4,1727896598,5500
83,3bDCHbLM63kd4nCmvov2g6ZaroeghVXfu5dM3eDcGxuDg6qsFsQgq9nqBe1QkBWtEdbtGcKqj5k5RKtD7NbXSN4P,true,293322073,293322076,3,1727896608,5170
85,3DdpmeMNazcmPcseXweZXQ98mTchQyP9816HoBTHEFJzCJa13f2ouT2PjLmRfHKS1bFpoz7j53GPLcs48FgKCVyj,true,293322073,293322077,4,1727896608,5214
81,2PoG6RS3faNZbXG1tagTSWMtURJxRGYCkcc3R47iqFMuzG5LQNeY7Zc7pEjWe9cVgbYsQmb9khyojT1c4CFY5gXn,true,293322074,293322078,4,1727896608,5217
86,2SPFRQ5qYCKxkkkA8qBWgD8vbmz8Jq7iqJwUK6HVkVEpCo1rywLMYoA37Q1H899KeAKEH8XHt7N64CaJoCiPdR6e,true,293322074,293322078,4,1727896608,5345
88,558D3FxFRiJxk87RwgUPGJHNBRVRtvLm5AfmnHhFLcva9RFt5sDzjEKBojh7AsymsPqHvqZ9fY19uPUWyNNaBrKH,true,293322074,293322078,4,1727896608,5318
87,5heaQwDLJtyAJb1cXwaYHtxD5ukxzsQmDmPdFp5TZpoxbYE6XHZ3fnysoBFuw9woF3Uzzv25fueCA1AzPhui3hJs,true,293322073,293322079,6,1727896608,5493
82,2RVbXmjN8we6tWBWFSGc5BzT3Ywhyag2gLDdpX6zbNHuQfZDawsUE9UCRngJwmvQFUYSXGsSGsHKf6N4NSKC9PcQ,true,293322073,293322079,6,1727896608,5489
80,3TE6jjc7zSn9e7yEvncZxuW2jWUKAwUszp6qwdSJMm5vh8u6m6wVi2eHGUKPe99aQtibHCvF6BDXDF3ugDGTKqky,true,293322073,293322078,5,1727896608,5531
89,3YskjoScP7mTdQPXmYrQnPj1M4JTMdKc2exKq1d9Xz8XShkDbmPq7FSqTjG3XrAjCo1UXeA3bgi6SCqCpvyWimgA,true,293322073,293322077,4,1727896608,5593
84,3UXGjPCy1TvyHRnCCbCw7rqW76xjYMe8rpLKEy1PdYyViLXqnKLwJ5aWJHqjw3DbqyeyWhkvTNVGfpHkT8jajMjG,true,293322073,293322078,5,1727896608,5659
96,4SXAGzN2CYtX8TpjxKvN7vvekqds8fm1Rk4D71quvuEhzxtm2MMsgHYKZmtRuPH5Vbr5FLxBdvH3xsZn8N9HUoop,true,293322096,293322104,8,1727896619,5193
98,51Go7Pd7oBT1KB2JnAY5zVHb8zFmvcp3YtX6bQvC9d4eCBtFKXV9qVHDfjStJrbejqMCgDoQmmxXvU1oMxX2xeHF,true,293322096,293322104,8,1727896619,5203
93,3tVhKR2BYtLDegZYAHMGHcBhhdYqtgF4BWCz93uJPg42z2crovzpiixdvZFAiSseQRnPLfYgdHaHMfwrpTV1wQDV,true,293322096,293322104,8,1727896619,5205
94,Fo9PvHSs2D2Y9QJB1avwjfudHE5SXNDkt2QNWwVM4JM6NGot5966DM41BWNEmvU81EzzFa57pL2BZFiUEk68skv,true,293322096,293322104,8,1727896619,5272
97,4Hvoei9jQMroQsovzgLiyYZAQgoUJQJ54YQYnjrHEjyXixn78GmTdr3bHfGpWdT5UdTD96E21HS6ZKZf5gNVjY7X,true,293322096,293322104,8,1727896619,5290
91,BwRFQAy85dvZCpf2GxUv33oKMGhTN3pbDAUYeUzUvo7KAHBz5WhSYKwBXcxeFF5AKmb7fMD3QAFRfTdYVsV6uBf,true,293322096,293322104,8,1727896619,5453
95,2F59KVPzhAAA5z7zkgm88izq6NQJxDHmw9trKD8J6qPcDK2HwLeP5pQ5y5WNFefaYCEwuv4N888NWC97y2AMnqYL,true,293322096,293322104,8,1727896619,5475
99,V22GKzW9HTT4Pdo11wy6aAJFRqpTAHzsPA2jNSvpmhZdx5G7oay7LoPdEJcyPPS3NHGV3kSbWP43zzYH8kKXsRY,true,293322096,293322104,8,1727896619,5508
90,5hpANBQZDJSqzpLepadJ3qmqxqeUHfz8wir9X3xN6sQpAvKVyBA4kP9KcnscfMYHGCTc2zQaoueW4J5jAbyXNCs2,true,293322096,293322104,8,1727896619,5545
92,4twCR9Y4fpMmD2HRhvXW3dMAjVtSkr9BwL2TU1orPDPzwCENfrvPpyg24hUXFzp8EPpCyKX1CiQ8yiKgmsf1UUbN,true,293322096,293322104,8,1727896619,5574
100,nHVfQGJAUqTzkPYAjH2oof6qqs4RfXUCQ3xyxHSZWDfYyQ4rGia6NzcYGi3nqLPhQJ2u2xJvyT2q4tKLi5LBnCt,true,293322119,293322124,5,1727896629,5189
101,hHfT3qS3tTMk9j2tppnYVDJfaPetWGthriXBZoUc5fp5kGFDs3BCxzSKuZMwVHgvTSVUANbkRfAPQoh79nNZXdt,true,293322119,293322125,6,1727896629,5194
102,64uHtap7rwDqjx3x1mkdMa1ky9WHWUpNWHTvT2hfVPQqaD4jpmTFQ6Aetm1qz14BcXyFsXPFp1fMac1RJWi1Lfrw,true,293322119,293322124,5,1727896629,5205
106,4FfQUrvGwJzypgEKU7iftrfJswth1StygQ9PNb5zH9TKxsFygu3bA7w2oGDXg6Wobeopa2TQbEPzccMmSiaeBmML,true,293322119,293322124,5,1727896629,5205
107,381TZtLsau8JWSUQ8jj2cK3oDEHh1UyPj41NSdxUAcPp9njqtqPTYqWnos7ewKw9gYA99RcebE6GKZ6bP6uYPyJv,true,293322119,293322125,6,1727896629,5207
104,52orAPY2QUdbXPKggReDsHVn3hQTeq3YtBhTxKY6KkkVNuNaS668nwmk1J7k4e5DPgD4BuaRB3KznYZA591Jy7dy,true,293322119,293322124,5,1727896629,5186
105,2g1sEjdRMk25FNAYqZCaGfaCrmwCiUvPzfWYhLc8rdNGxL7i9UHUiEcscD7dp2UEg415dG16whdfnzrn8Lqva9rS,true,293322119,293322124,5,1727896629,5272
108,2iTmFweo7L2MBvvqCPcvyVF1WTDNp3KiFkHicpJbQgco7N1AiaMeRHx5NMfZp5fLTaE54kpK91M9dtRxft8HP8RG,true,293322119,293322126,7,1727896629,5435
103,3LpkUCoq2b5DoBGQaY5rKDFDgVMS9VbEifeAbR1vyQQguwBb15Khs89pzP5T7K3jQBfiAAFgcspzCsTWXoKF8sQJ,true,293322119,293322125,6,1727896629,5538
109,2jx1ATr8EtRgwoQqVXUgMgE9whFYCWY9xFPzYQCzyua8YQnowtu6VgWGeM3KuJtES2ecKqqKa9vfsTPdxy42nZgz,true,293322119,293322124,5,1727896629,5630
110,kgbd3rBj1GEkQWR1RFYPrcppiUuCN1fqPjwy1qGcQWEoTGrrn9uvxBjtWnMs5FyECVKpEJJTi3TNBuZbMrp6zxq,true,293322132,293322144,12,1727896639,5186
115,5pp7LjiNa4F2PFqiSGsYfbQYVeQNUcKvfB3HRU4XEuWamh9mjbz1wRcQkxBWWQFhgNiibyvgTvJseorN2JpwMJ14,true,293322132,293322144,12,1727896639,5187
114,48TdS4NeaGcP5BzcvFydvF3LWWMaw66Xbzst1oWTbPaPvQKv32PEUebetWhabvKv1tDY2wecwXwbf9pydbM632Ki,true,293322132,293322146,14,1727896639,5209
116,494YuLnPJGVGhqJaa7DAF85oAEBxaL5tm8FEMd4J3X6Kv883mHtb78VhxeSfRFXe37e4wqVrRR77ZAUywzMrEX9f,true,293322132,293322144,12,1727896639,5209
117,4qyfjQ3dgpWdVqgWjYFwBr2xYBP4gVJTYP9QYviWX3dVqhoh6mbHCqGzbzBCocNZw5cee4cJ6xjEofby5K3ZHqXu,true,293322132,293322144,12,1727896639,5199
112,5oX592VcqRchEtVm4MjFuwVW3SNSUQj2NSjCgAi8HSw9Zbg9cFPTWvZ2tDUfLgru9tiqWCpwjVMFCqszFqr7qSzP,true,293322132,293322146,14,1727896639,5189
111,2PbiLLkYMusQ9y2hsUiUX57FTsHh2jWLNqGQVRoCuGNgTWQDQu85DQPtteSscNzDmQr3cufpqH1VKPKw395Jmdeb,true,293322132,293322144,12,1727896639,5285
122,4y4ks6UMSJhvQLBsURTrNEroDjaHJthYGzGTZ23nSTHLgx6LNhWqgMw5ctjxQDYCVy9A8dFfaAnh51HhqASJA18X,true,293322163,293322165,2,1727896650,5201
120,5vK6KWYQiio5x1K66GEvMLm34dTab966pB2JrJLwyfhzAoW4MZzKcrnvdQZhXqUQnrdSYa3uxrKXsvf5CAThn6N5,true,293322163,293322165,2,1727896650,5203
123,2Fozb6Lek8p2fJG6tNHPNUvmze7tcjx7ZSYsNhxgzitnEkBqMHsTkHrKyqQANfvEk7BVJ4R7uTW8KZEmhewsckLK,true,293322163,293322165,2,1727896650,5195
125,2w9jMrDKdeYnWGH3NpJEBpPLr5RfgXTRvxnnihLuJwGzXYTvoWtQvyDpUrKuctZdgwhotH3TVEeibfjWDWqH8igR,true,293322163,293322165,2,1727896650,5202
128,4Z6ZRoneiuUocSfUCQF3QkX5v6RqoiYnXNADM2komemUS6x7YToEZvDXC8mFeoAJeVEomuYc2Q1eBhEKL15tqPYv,true,293322163,293322165,2,1727896650,5227
127,4SniW9Hwnkt1JSAnMEgwb7xAhu7kQ7W8xzW9HP2UbYiHuysrQCKCpJyRyNHWCk3UYspkHghQX2o94JGvyRVtEsdV,true,293322163,293322165,2,1727896650,5273
126,2inZ1Skn9Cj12Xo7up5mDjdBZZeXjAvZqAxgTdPXy6obnbMBHA49JSaVPeWbR4YqarqPjXBg1UgrreicX8aRmSWm,true,293322163,293322165,2,1727896650,5279
121,4kRCRU4KfnrEuUCxJwcfCPZMoVvnW3ggGUeDVn31NmK3NDgVcbb6m8AHpcwbGbDwjkUFbdTFULYZT5VzT6YGXcXC,true,293322163,293322165,2,1727896650,5275
129,iKKxpusqiHT21cyAeJoYSQVDMX4asqyo7ZTBg3gAbezDrMBqxCf6B8875iXUS3QQR2RaLCwzMwFWT2eWY4jNYxo,true,293322163,293322165,2,1727896650,5270
124,53cLn3UPrHiaUz1z6V9V1uWZzX8yKDUj2Q1NiRt3WW6vbZqcUoSDQigci4KhuZECSmo1qcTXEYPmG43QKiCQZzR9,true,293322163,293322165,2,1727896650,6636
119,3oJueArrLPUCQhkdxvMq8mYPCLdJe6ymU27EGNdP7qL2vJXt1g8SyGLepdQrFTxxgEY4F9pYszPkiBVcLGCfkphj,true,293322132,293322176,44,1727896639,20589
113,2GEoUEev9TJonRxNPTs5NJBzmJ36UJYx5AoEbE8L6iomm1S4j3973r1dCsYiRCwXS1aW7gg7xMzoBJtdyzWSxM8K,true,293322132,293322176,44,1727896639,20673
118,2fi4BK9mCJCGnx8xZyJvJjxupvCsQrCNLUJc8b8RL1xptYDHh2pX6w175HaS2nu1mG8cVJr24KSLhgsJZbrXnU6B,true,293322132,293322184,52,1727896639,20739
136,4gExiceNQVNWVD1NipPBFhAqFEHyzi78vPZWF2rpKLyvonP3C5Dk6wsYdTYiMnPLMsXouZdBbjkWXJh6qp7Ddkh6,true,293322188,293322191,3,1727896660,5179
138,4KRCvfd8Buw3isPiPWCU9nXgRhaNhJ5o9VaN6gmceRMTErVGecaqZGrjhSkcqXybYh4DiX1BmFupPwrWpQzT9Wvq,true,293322188,293322192,4,1727896660,5200
135,3cM3YHNzbVL7WXBnjmi5Mpqgm8jNA3qLsRG9nwm5uANem9eHpesqFifLJjbNYf4yRNYkGy6oNzxVabcNRbP5Wj5o,true,293322188,293322191,3,1727896660,5207
139,3bf7hp4QfsWgf85HfRMXHkazhoGb6QdieEz12SFergoUu51DyLUtQWwigXiRaNthJW4PuVLvcTUsEVyqUbTW6uNd,true,293322188,293322192,4,1727896660,5212
132,3aWGRmN1RLTkhz2fXHqDhdTNgo4KSyk2xu3Xvxv63nT5Lscdwe2eNFFp5VjeXsb9aCUyZcSEP1UpB4fb6J16dbRT,true,293322188,293322192,4,1727896660,5203
134,4G5JvCx6zs8qUrcc3vyf8yi4AmBqCNZ4ks5VfSH8KWBQZBWjPmpRBtapYcsU8dUMbRbrQUWBXzeTzz5YB4Zwacbg,true,293322188,293322192,4,1727896660,5206
131,27oCBFqonKqvhTaTdtzbGjzUdu5gctXCTQ4FSLhW9q2GEkG9KRFKdHpQZq87yugcT1BYCgfkgQzmK42h9vvutU8M,true,293322188,293322191,3,1727896660,5277
137,3M6GkL9kbSpVp3rRnBNxbrzQfEjaknFvdPwjS7sX3agYqQEXi2QZXfeLNRru2EBboTNeG85SfW5WhaTYTMqMdhoT,true,293322188,293322192,4,1727896660,5464
130,ZFP1QuqFWALACMtaQwkcw54FNfERAt5dSzafKykrNNd4LyD8o5YVjoVDwbVctYzs2MBh2JxEEKQjH3V7f9AmkmN,true,293322188,293322192,4,1727896660,5559
133,4rJ9sAKjH42AgtG2QNKw9ntR1hF8zwWNs1y2MHzp3R7AJcxU4PqMZfNtPa9CeUtBPJXPbk6gVdejSwpT1XrUHwr4,true,293322188,293322191,3,1727896660,5568
141,AbDZT7bRczbtnFZ4RDESKFdW8oUGwWv8DsJDJWhr9tPbeVuzNMFyMnj7WJPpn3VTsVuZEUYUHC6KJcKhorwVWvC,true,293322214,293322216,2,1727896671,5180
140,3yv9zpj4GWPQCqJijathVqrpuTqo9RygKz6N7JpfpFu1NPdUahVNoXHWKXRdnfvsiG8E9nxuZcfuvubKgnRV7Tc4,true,293322214,293322216,2,1727896671,5178
142,4AQhfTg6Aco3nuNXK8wxQ3Bsjr5Ar9grz3bG5X3VQFFn6UT6JeWNuEmJ9X1kKUbnmb8XpE3dwY2qnCdaRFZZjDri,true,293322214,293322216,2,1727896671,5184
147,59iiivWSLh2GADzfY6KveBjxvWvBRpe4YJx8NQrAKAg9HBfC4WuZaxv7wwqHNqNPSh2qU1NdXzYH6bbCWi16ezYj,true,293322214,293322216,2,1727896671,5182
144,2M4CtvhcxyVAh7wDeVnMjVSJHSEpE3M7S7BfMCPG7ALtxCUbKb4aercEisYpWn145vNzVKSaoCr73DgEV2p7b6Xv,true,293322214,293322216,2,1727896671,5190
146,5JKq6WySAL7qsRhEshm6ivH8f6chGPVneuaaGtHiKLGAL4aEXDsKedS4WoDvrmDS71NX21kGvPCPze6HCzdzziVq,true,293322214,293322216,2,1727896671,5197
143,4qDPB2L7Wte2VHZdx1HXF35uZxgj3TL3Bt4Yi7MhhWTdtPiFZsXxVAk8yj2hD43pmpQigHXRyc9S5oCtNmoRLMa6,true,293322214,293322216,2,1727896671,5202
148,5EgQdLzHCRiSbAV7cuimMEpt5LkxpQw3CFeJbGiFx1RKmrCYGqyNedLwRxjEi6YRwP84ikniu2QzhNcU7GCmY7uu,true,293322214,293322216,2,1727896671,5211
149,SbxYuTpro1ZFkt4kXZmLqpkZ2rMPSJmJz7LsfLvWam5FYBUeNkyo8JTaepmgoiBPG9QKTJkwmEQWj6ujsFti6Bt,true,293322214,293322216,2,1727896671,5206
145,xUyGsZs8JsgwhdXZ5Uyki6rPzqsupuWaaXRo5rho2d7n6tJ8x7Z3Nj8xzJ7AmuYnxwATrafVxZNm3DfJDUZqL3B,true,293322214,293322216,2,1727896671,5298
151,2sGFs9f7CXVm83ibgXLJf32BSMfbccmuGgHsJVBW4TiJPAXw8X6YzMv18rdcroZTCbAAvDhXq3cC3kgVLgp51hj8,true,293322239,293322244,5,1727896682,5173
155,3S93QbRf5G2EcufpcSVBoFFURFqSzXLdzgPCM3gvePN7nycagFrzv5iHQE8VXdVghBU6GTGjg3M8JkabJHdeKrEM,true,293322239,293322244,5,1727896682,5160
157,4a7Zh231i44t4tLheyL9BVu25DtDyd3Uyx6RoRPAzHSak6aUGrtD8c5nPVD6r8E5bMnYngRmDe2kCoayWPJRntMs,true,293322239,293322244,5,1727896682,5190
158,4eLVXyrfJJF8Z6hSwv5tBVaHbqh5wb3jesRD1DbxeiZLpGgr8PUZdsqe2hiYtbQYks9S3UUwTzWL7VSiXY7GrpwM,true,293322239,293322244,5,1727896682,5194
156,UAACSKTTZMBvyVoBLAcZTNs98r1zsAFHpKTqJs68tLVZY574vuGVckMSE2VfSx4bg1q75Mt7cBeBebNkyQNJubi,true,293322239,293322244,5,1727896682,5213
154,4S5onxZFR1jLfcCcsVorkcDd7Qa3XEzTTbhJV8HfgMPKtTs2reuM4nKpsdFEB5wjyWmkEw4mnTnb92GZTRzq2X5Y,true,293322239,293322244,5,1727896682,5284
153,5yEXG5LNoZhHWfsT2Tw92rPMjRoCLeTaQiWJvAAQ4byhLyu42NqnUMc3tXM4ACsc34bbfsAVWb1UjXPBd5yJn4oL,true,293322239,293322244,5,1727896682,5281
159,5im9KwZFPPSEq4oNVHjtB1UtvCipa8x4khXt5o5ujdXHmYr9T4XEEx1sfxY4CoJQgmqqSgaQyGraBnAJGwizGSmB,true,293322239,293322244,5,1727896682,5311
152,2DC46etrFeHHcnQwY5D2Kxx1zPRSE9c7CRHnUnugzyJ1zxN4yG2LWBwRppEuiKcMvZszPMneHJWyYXCAkf6nXA64,true,293322239,293322244,5,1727896682,5381
150,2CV1UniALhuqUqpxxSz8J8PKXPwWGBenNJfS24TeMHao15T2ukEBDXZWxDYeywqLhmkv4GqML7jgwQQvXNM1nLGo,true,293322239,293322244,5,1727896682,5571
