id,txn_id,status,get_slot,landed_slot,slot_delta,time_at_txn_sent,time_taken_processed
<<<<<<< HEAD
3,63oKEUsEa1UYdnGBw4wiahNW1T4NFd12V7wBSNUbMX3xHQJePx8FwcGraxpnyn9xqLgavPs1pMJ9Dsxzo5jHFLDv,true,293321891,293321896,5,1727896524,5461
5,42tyjnYhF8WVQEZQhXgKgjHqqPcrZXGvYgvknyLsnLTWTtkpUiyYqdiLP3x1Qp4xh9dCiEknDRhtKsaGX6HfuQcU,true,293321891,293321896,5,1727896524,5493
2,28fSQUGmUWRqbf6USykGAgiBYoq2YoiaV6V1sm6fsjGDkrjSoVHkWktSU9TCH6QmUbYqaxju7eUmneTcMh97ihW7,true,293321891,293321896,5,1727896524,5469
4,WUyCiLCHZiQ3sncS7QwoheRJearfU9w4stzXS2MjkqLnNxvcrR628sSWiYuXf94s8TKUDNB3NjmzyDLDmbBGFpo,true,293321891,293321896,5,1727896524,5454
8,2dpkKGjfUDYJEzhsqGMi8km8Zxra6C44dTW39ShQYvhrHb1aUhyix33M8UUcGwL2uiKm7Zr2tAdjAeycPE2wFipm,true,293321891,293321896,5,1727896524,5553
1,26iFpAqWfaMwmEMRwFSWMWogFcZEe6KLAC1wyEEnuvGPiaVmoSCVsfNHrgS9Pv4jvoqD4rw25sHVVYLLQ7vdSjJ4,true,293321893,293321896,3,1727896525,5479
0,56tLnvxwbex6CFBQcbhtFiREgCTmQLJ2d6Zef8efBJb2f5rdEDSDMZ3hLZzkAvo2X7b6aoZ2B7jytaFJwTJ3YJt2,true,293321893,293321896,3,1727896525,5623
7,LH73Vd8NrHG8ajQY5gfoDdmnfpZrco66MmZg4GpcBNenDn9RDc9TxEAu9yPf8TcHdGRm1iE2S6kHcmdJoioqpsX,true,293321894,293321896,2,1727896525,5424
6,5dT7F9cjyXySBLJJDrcCkLeCS4GgtyHfkeMgKJ82o5XLSywnEVyPm23YZQN7PPQNPrva74pxSknVbd3p9jECW5tM,true,293321894,293321896,2,1727896525,5573
9,SdVS9jmHLKnscJUoKRehSAErxbqFaKrFmw2FLSCQH9U8oJLRGZLoViJAzTXtFpUYzHArJUeVkNQkiWgAsWfHhsP,true,293321897,293321900,3,1727896526,5485
10,26PS7xgXyj6xek7GRjc4zez9pFFWxTf3VWEtVaHJ9XRVK5emRTpWZpZBPiBybb6yU8jtCJ9KriNKJZEK9UHUVC8M,true,293321915,293321916,1,1727896535,5299
15,3QtQRvzqL7w1iQEkS8esugYrBFGkUsnjycsDs9sR6K5hYX1A3LCRgDYeSYxfUGZZ2SDAHtuhjMYPefANDv5CKyqC,true,293321915,293321916,1,1727896535,5452
14,5wkePBPKuQVtPac2hqTAC5q14tR5FVryvLkN1UbFFqFZb48Gv9zGkKcGsXjQ56AxjCU7BfR7LYZHJx1RdiE22Pi7,true,293321915,293321916,1,1727896535,5551
12,4AP9b5iRRySjQ12epciCvTwCYZ7g8PCKsSo81gBU17YZ5m1DKvHPvqBW1P9A9VGkDf8GLjtfrLZHXf7ijs9LmuKT,true,293321915,293321916,1,1727896535,5535
18,9GfEufYR5fTjPE167thfsLLohaF9Q5tuBHb2pCtnFB2rRA4wdYcaA1juyneRx7fQHiEFiPiVEaQxchREMF9iMEa,true,293321915,293321916,1,1727896535,5655
19,2YypE8D4G8NfBh6K1UuwXJDjScPhwZGhHA6qCv69UNyrJ8cf8JWCiGAaqkDzgZgC49p9f1dUjhBx2DeZz5Zrrdk2,true,293321915,293321916,1,1727896535,5179
13,sjDFE2gkfnhA1gC9iLfbg8KZww3gJGZvuXum6JRpovN84LrhaitGAnFLk3wyLKoxwbK7RuPZcL1cZcs3zo9Tv9m,true,293321916,293321920,4,1727896536,5202
11,3sfhqyjTQJis9wVyXLyjH56ENdhWfMNHhibJ6e3dYUe48FgFDMny2Q8fff5ZYQaYDG7Nn3fs7hX8hko6u6XJaMzK,true,293321916,293321920,4,1727896536,5276
16,63wSRd1MP47KryLe5b1yjyyz3H97r9idyCHHWVq8MCqk93DSiMpDo9CnNd93mEPx2rQKMt1M9TNZF6AzSNYprqei,true,293321915,293321920,5,1727896536,5465
17,2F38hggHejA6P33TT2cQ53Gwr9mMz3dDA49gwwq5SB5LTjbsGUFRJa4cyoMvMKRYma6KrsFfdQHJMdiMxLYJoSCX,true,293321916,293321920,4,1727896536,5469
29,58HRymaBaR7vpzDaiAMqFLhvivvvo6yiWK2vtN6zDH1kMXsBobzNXbV8qFrN8ocEcMapduhAta818yEmgj7zMPsq,true,293321939,293321940,1,1727896545,5225
27,5p98fiWtz4LRcVbKe77BtGjWZwTqZuFSAHzozncpMPh8KzpWNZ3x8ajJwyvDCTeXk2qnuPBD7y3pWFa5r4YkmXjc,true,293321939,293321944,5,1727896545,5207
22,2F8sxEUvhvNR9c7aSe5GUXcgxXGrF6742timisyfjxRXRLsKdgdVKAnCDiWiUtTNJpyS3ZpZCA3ppX4E7XsZvetw,true,293321939,293321944,5,1727896545,5285
25,4xXzCvzyEB2VMReZ6PevaqsJ6Zf6yrAhp2a69c6g37Utqpi12wJ6EgXd4aZN4Kg1xNUjkKHhobKzvDYcDKVFXBEe,true,293321939,293321944,5,1727896545,5464
26,28P9pXcxQsPUA4kQGLTa9c4UedH9RvDMryTEWshzMjZ3b11J8eCCBSMk5iNm2U52LjhA5Nr6WRoaE9GSHmaMJSzD,true,293321939,293321940,1,1727896545,5364
21,323fZwz4s7HRj2qgk3GouL8ANNosucQQG3tRnzdDq5asxqVc5aWzyyTGGZsNNKxBH9eqj4mt8qGodm5EWtvFSWbT,true,293321932,293321940,8,1727896545,5554
23,4ymMrhvpa1YLbwbygdR8rxujDg3fgoBDGyTXANjmXKT2rYRwBYX88f3GCrkgpJVzjcmx3v6hDPeXKd2ctdG88CmS,true,293321939,293321944,5,1727896545,5269
24,4mSynZCWKy1A7MHJxzc1s2WdFr3Z1CKQKG6t1AnPZuj8wvT1E2mZ5gTqdiMPc5iuKt5hWqyEsnqJYpU985B5QB5,true,293321939,293321945,6,1727896545,5466
20,4iPi9NxWSYRGiHub8wkNTqQnkNMGkE8ukUfEAtzrk5sLRzzKKkvcgPvtU1uc7ao71GmhyPDn4BrJrwAco45uECgV,true,293321941,293321944,3,1727896546,5198
28,4mSynZCWKy1A7MHJxzc1s2WdFr3Z1CKQKG6t1AnPZuj8wvT1E2mZ5gTqdiMPc5iuKt5hWqyEsnqJYpU985B5QB5,true,293321941,293321945,4,1727896546,5580
39,3Xwo6dT5mbwsGAb5UPMJA92Me3wmpaFPz5JmM1tRWt7hn3st7DWfg9K6CkAY2dVQnU3V9E65dyCFEuMk4iShg3pX,true,293321959,293321960,1,1727896556,5475
38,258ea147gU9Bhkby4YvSoyibDuAn6DYVz1HPSRngzYSVyqYYJFFLcj33KdC83y5yYjJYW2jurRYG7cKvcuMmZfJW,true,293321959,293321962,3,1727896556,5361
34,4dyhT6rhECovDEpXm5iKwrdjUfB4xWuAyxGMg5tM7Vj9NoUCurxT2dVGC491Ki5LnZg21xCgTCAxJUyE4aa96mKV,true,293321960,293321962,2,1727896556,5212
33,dD3hfVJZFw3HnCkwQHtBv95LqLW4oWpzayj91BPBntutqJhG68k8qBZeAMF2ib5eVDEdwZEg2TCvZXyuTFbAJ9B,true,293321959,293321960,1,1727896556,5531
37,4KYHw9KrGSqeTw18iwjkGfP3AP6khMtbYYVmXqRgrrsTDkwLUXgNS6V5t4nyAbzqn9WMBZ8GX6Vku73R9fxXKBPH,true,293321960,293321962,2,1727896556,5282
35,639Ns2NZrSRscYd3bbDiDo1DaUq1N58epVERdczQf5brQuAKeQQs9XH9PARrJhd1PDFhAn4jspYxoh3nBeLDgQHz,true,293321959,293321962,3,1727896556,5552
36,5oTfT2wRtuy1cTVm1BTeVZtKaRwwS64xohbcA9CEmMVgDTn7rSFfCwt35csBVAKtZsc87J2eXKaYChkcEv6Drzfe,true,293321960,293321962,2,1727896556,5286
32,5UBLuikt5pm3XnJ7Qp7yP4yuy7YjUfJRPrbrT2ShUG2BQL4DcMAHS9KaQabydA35r4LZtnqo6KGdmCrPRjmnjPU,true,293321959,293321962,3,1727896556,5354
30,2i24rBG1i6NGpUTKo7j9wdaL14DVPytBU6KLPTVitqeQEFg8uTY2te2CvuBGrchXkgz71trYwPEZYZE2jB3nYTNy,true,293321959,293321963,4,1727896556,5454
31,5KgC3NVAVKVb7BsKkuNvKACZJAwhmKV8PYEVDcQBAwx4m6gxc6no4znJLdoe1RC7FS5bugSYmchPnc4Z4V6bgD3K,true,293321959,293321962,3,1727896556,5513
41,pmxsATjhudJYi2XptNw6pKj79yjykAJ4yGmukvuFrJLTovYYQat9S7GdnmzUyoNYkcL9kkphnHZfZJPWonQEMH2,true,293321985,293321988,3,1727896566,5264
42,3F8uTKvSsr3PH7eGgdHTmJTT7JiCqXZ6XdxtyPz6gkc2XPv8aZqwV6FuAKwuzraNBE2xSF8f4C7SpZWnwPLQkgXw,true,293321985,293321988,3,1727896566,5278
44,2NhqHCyMut6Z7t92ombW9CupVa1q7qgUVEjXHSkWVGY5pTToqYafeXcShDF1hK3kyoW2Hbe7Vy2A9j9u1ivjXQr6,true,293321986,293321988,2,1727896566,5278
46,3zJGadfefAv2A9NBoPU9UE47L7xPvjYEbWNrFDZaWL7B8VY2UckuHxwRoXzfsWsLHu2x5McWStepxNnVcmAdRZLN,true,293321985,293321988,3,1727896566,5498
45,5BvEzzFRhybPLgoXfWwrvhCNBvRi6ThJd6VQL5W2867UdPKbzrHXFyx9nTMn5qURT58hp6xQQmQ1cGRY5tbyyFpj,true,293321986,293321988,2,1727896566,5295
49,4YWRmLn48M5mQ4Q8XoV1wUg1keUnAY8thdLo5twfZXtNG7M5TittgDPFhhfDqAF6EyPyePwjnTbJ5kzpiwHuAWB8,true,293321985,293321988,3,1727896566,5580
48,48YfkuZQuELh4ncQR2yYXyTFqUjsJuEk6pAdPoHDi4h91chUgUN4meRpwBcFMtJcnTTv7Lrizzgg7zJmAbc4K39H,true,293321988,293321991,3,1727896568,5267
40,3uErDfNFPvLAdfzGzrn9Q7TBaPjmqNKghoDWA3cEGxgUZUEz1SNmzw4KZCPSuRxAdmDotxwHZUADnGnGLFBppJhA,true,293321988,293321990,2,1727896567,5469
47,3sVKD1pGtemUM2ou4rsiS1DFaDJ4q5ke7K74caST9eAfxzrFkowDGS3mknWsL6wb7mZZnj7Pb9n7F6kiXcNuVG7C,true,293321988,293321991,3,1727896568,5448
43,5sY4YefVsvEJFeTLLtGBoSpwCAV3FtNfsKJgu4uuT77Y5LkxYf9DxUJX6rZMwqaymzekszvsxV6zcyFwdtKtHuTa,true,293321988,293321991,3,1727896568,5517
55,5sLmM9wYnhGdiri5QUr27mEyeF6d46n1wxqRwk9FYJfG4fDwxYk5b8pCfEdWd13ZetrWQ1sFQjZcWYBjmCUSyvRn,true,293322003,293322008,5,1727896577,5190
59,4BCcbFcVtkUtKwXigAHKMdPuYPcYoBTTpDgFjJgYSk7q1cL41S2xzuhQgpanNTLnNfV4ejseiB9MGdQxMiRTQt2q,true,293322003,293322008,5,1727896577,5212
54,5QWkxWtRcgBoY5rbtjz4wBChyYS1djF7KqrBMkinK7cnT2ifxyLVewJDQWrrXtT1X1mVfbqrkaXxU1tNFsgAeTAQ,true,293322003,293322008,5,1727896577,5249
52,5ZNyZxgaNr7ofa1yEq3P11adL66NveCc4E7roE8pN83NW1f9eScFhu91CGaJ9JtjW86Drd3evBj6GyEXuxd9zdda,true,293322005,293322008,3,1727896577,5180
51,4QkDv7R65eQpJD2y6sLaqnt96K2kwmcyc7oYWTPSe7VvPU82Gd7UssA1gPHnEofYTwdzgoCxf24xJJB5BZcsNZFU,true,293322005,293322008,3,1727896577,5191
53,2H36pCooxrY8VVWvGNwkuWuu1nn3Tr9o9zCdpU4s2oXVhVfJbqB4eEdtEqpLxDkrw5cXHSvEoozmXKuKcKWEmi7K,true,293322005,293322008,3,1727896577,5198
58,ZZ95j9NNUfesFtdGxDMroC1KrHWmut9wSJBVVQtVmjMCS89xq33pkbN9NtsgCRCAN7gncj1KvCWNhKeXwR87PmN,true,293322003,293322006,3,1727896577,5656
57,5eh7b2HDE473FoW2WvbiWGPTytREEYqnFEjXqr8hEkEHFKKBxX4Rt55xx3kYsBgGWincuYzqHJ4nGDzQuxjbY15f,true,293322005,293322008,3,1727896577,5408
56,2N3GfVfn6gr4fjo5cZ3qfKXHDa6R3qxMY1GuDDAPpWqcEmMP6cfSRnD8RABn8gsBD31JziD1VNUBEHUysYdiVSi8,true,293322005,293322008,3,1727896577,5446
50,3o1Kdi7mHw25ih8TzAJAVwBHZEbV4qrd2Mnr5TZAdf9qEpE9cCgHR45TRASjtMF7EQPswVaUQ1uzY4jH4gSBGZWZ,true,293322005,293322008,3,1727896577,5498
62,41vxJ3H7ndewyV7peCThJLoXxKpRH8o3qtekeAbqcJrnWMyWay1RirLe8ai27dhwCSQXwZW4e15h33weQRsekVnP,true,293322029,293322033,4,1727896587,5203
65,4DUrh4BfDoUaqZrybgj5UCtmcwrtwyQZNkgVwndyyrc2Eqwxsz5x8GAadSjPXWQkBvixeN7SGKGaijF5eTu2uT8R,true,293322029,293322032,3,1727896587,5199
67,4PbEHCFK9AYmeJjmDKXhAamPSAW1SfAehjyPtHtr4JSofNkciXuvVGy5vnUk14jj6niMoszSFGxUU531zwpRZ2cU,true,293322029,293322034,5,1727896587,5228
64,WvpaVxgLhRMKgPLpaF3jbE1SqZCcCHpuPyL7KMr4qzEXU7Y9scfFHfTdGwFBjtmBSnKHud83441pWdhwy7whDuk,true,293322029,293322034,5,1727896587,5247
66,2Wr9rgsGnKdEcm8VJessCVkVS3waa9fUYVpR9Wh3YjP9NVBdVhsgh2esYXWP6ky4JbJxdQ6iKoFouYbbgkbm293K,true,293322029,293322034,5,1727896587,5458
69,5NFx4c73hbQmqRL1jWdPLELL9KaKj7mVv6LBXn938RHkfPPsbd4evdzfGXfczBf9XGXyXEUjMMdKoELARh3JpppZ,true,293322031,293322032,1,1727896588,5277
68,2Y8jvsQ7Mkz4svCCYGRwmsa49ogdnSHRFAkzRB2qvGAUuoJXTh9W3qp1hfUTVVa4Vde4MTEqxrYSXy4W7kY1vd3V,true,293322031,293322034,3,1727896588,5198
60,3aWhozHUTLUuVyZg77kWM1jnwQt8jscUda9TPEc9zzuaKtshU95VFt9tHwukUt4tYsKAQGRug2KDVzJkF2EtBpQF,true,293322031,293322032,1,1727896588,5620
63,fwUput5qWnXqx4dDPUtvuJ36N1XXk9ZDwwudCW9AjCssJuMcWygBzSfm6TubbTs7qnkh9VAHh3REYHAFR5UbEpA,true,293322031,293322032,1,1727896589,5423
61,3FQMgWTL4pf4spJkzEN2xRkbMPf6iF6ULsDPqKhCCE6gq7qcGQKHHVKoUBbmFKjX8S5VzMmsYqf262eYLtvoLNkT,true,293322031,293322033,2,1727896588,5496
72,4xir8JNLF9TSv6baWCRYk2THgj5Tsjz3diKZZNkW7L2TgTLHgyxJZkBgjLF2W896nedSKAfgmxEz5wut59ExQpB7,true,293322051,293322055,4,1727896598,5193
77,5bYg4U8HncW8LV1mwqMsuQG4FkZnMeHHYRu9QTrif2iaU3D7W8WJnHTGTyrT4qsyKXGkZas6o4swMdV5WWSbqm4p,true,293322051,293322055,4,1727896598,5246
73,3r44zkRFuSHsy37HuWw6Bn66TJdv4XTeW84DauvHtmrc73abTCmJu1xsnZKWVhPBKUQamfgu1KqdsUHDfwnGccEb,true,293322052,293322055,3,1727896598,5269
75,i4dmcvufi9kKMHGGExEYRm6wAQG8uLgTaFpNLi5Qvd9ieNkgbCZ6tYAbPabMnWQsYqDGhmBrtq92JPbNbXdmmEC,true,293322052,293322055,3,1727896598,5192
71,4huJPEowtfKYKajfTiJMkc2EMWGQqLrFmLTRWLcxuvkxBLDEisWbexx8iAfPkir1hhWM6UD9FwzoUMknm69VK8FK,true,293322051,293322055,4,1727896598,5423
74,2Rd8CnuViP67jPb7g71hBYmG8EbW29K4tDXZQkagMSsfGYVjkiQQbRxtDazorcGwxZT3wYvnqvbmksYXJ2WmHQxo,true,293322052,293322055,3,1727896598,5284
78,5v2WLHoGraJU9enFQNGFPHb4DC1NfyMbgPPBGURi5KjHArX2HpUfXeZApypJiY7LBPE3fAmmCduu5kinK6FpfWA7,true,293322052,293322055,3,1727896598,5184
79,2i1NU29E2PKd5Vc8QHsVJ2wSD8GtGxKwra3nF3Tw1AaLkuV6F4RTmH4roMqo56nrFto2B4MiJf6nr1n4AdhVMw5d,true,293322052,293322055,3,1727896598,5288
70,AxtVon8ADtmsQcbqHQjdxAQkSJR5FbGTxXAHRWV2Vu6vAVyC8MCTvsjHM5XUXxRvH8Tw9DrMntFeNE4DrEsdP4i,true,293322052,293322055,3,1727896598,5495
76,45sa1j9gJRTr7qjtf3sPcFZWFZpq1ALfBKMnBUasg3k9wwdfuBSLJemU3hTDz3bFFGZ2cSwHj9akH5spksxEhHL3,true,293322052,293322055,3,1727896598,5505
85,32aFxBTVZ5nV2bKhBDGDuSpj3L8e25WfTkVmY9pg7x13wPGkGEEYFXkKauCXE6m63zMGvPNHLvKZpcp2PFBKx97R,true,293322074,293322078,4,1727896608,5146
87,8FLcjKMVRjeu8CaKBEDLuUyxZQJpyfcfoaiFs6B5Qo1tVAQZfqsLWxCmx5aSaz4dBb47o1vdLG5GJ29nhdDh5x6,true,293322074,293322077,3,1727896608,5271
84,nrzWbwpdWVMcdVAEatVDbeAaZAimYzgPPMkZT6KQf2ymKUgyj8GFUJiVAdG4QVPsHCwVNCQ3n7YfDhEPyoL26Ak,true,293322074,293322079,5,1727896608,5237
83,5uhizeJRpaxACnVNqoD5JfJL52ogP1kghoYg289QWxFzCNds4b9tacVtZnzxoBJwDKDduaskTcTyE2iq3GQP7zGr,true,293322074,293322080,6,1727896608,5391
88,5L6u8auBhX8s5GtGdwC5b6BLrmTR3UYXX4yZF9EyPLkKb7QbZjVH2waCy3NEz9zbWqG7McRzUU9iayHcJ2FVhjMQ,true,293322074,293322077,3,1727896608,5582
82,3mXTN8dyuVDWd2pCr4gw79gxmomtkf8EX9aQw86qjRcVBMLAwU3SUNqAzQTVyhnnkmsoMLeRzKGpd3Vxch3iUjGw,true,293322074,293322078,4,1727896608,5549
86,4fthVQSen9CTGUx2hkRziAhEfJxAKMWSqRwJqW4NHRSSqoHKE9Qu7yiZMxeAEwn4EKkgFyqE5nUCHwKgvgYvtf4U,true,293322074,293322079,5,1727896608,5570
80,5hZM56mm2BwtCZ3op5PZ8KAKQWXvih3xDv8MTKrqR5dhMPTyRi7hn1pyvC76FYYBrVuvLZi8sa8HHZWp7nRa1hA7,true,293322076,293322079,3,1727896610,5148
81,4xAbLm2BJULenauckpsiSmc9LJmWWQf4irbqVHvwinY2topE8L4pKQZNGQJeRZ6fk8jVtrGAFC49jWVbZVXcUB7M,true,293322076,293322079,3,1727896610,5227
89,DqNbuVywFRYwh9K7a51S93wpndy3q3Jw48dLEzds2czcw9FY5YjojSVn8ey8seNaNQ32VuZ21R2JRT7t8ShB9c9,true,293322076,293322080,4,1727896610,5398
91,3PdZkhG4jPgTmYS9aabaG84S9J5euwMYBm4JW8jG8iKo1itLXR9QwcZ5jhmLJwtJJNs1H75uzoFwsM2UxDxK8TFM,true,293322096,293322102,6,1727896619,5195
95,y44JykA2pMh9aVextoQZ5hVoQPFB4Ni9bWXb2iAk7Z6jGKnTbQJkiaedcRfmeJD77GxdRCYUYN5JQVw11AGkKdD,true,293322096,293322102,6,1727896619,5201
99,4nJzqpvrGjtYR6upfWHGDAoh5fTGUqCRSvoEVVfMFV7nw72DQuX2kWadLVByESECBFVX6bfQ642LNLiNeZoYhZh6,true,293322096,293322104,8,1727896619,5196
98,4jko3A7Ne3N1P7ycrT5yz4rifQUZKTULt5ypwDf2QH9FurZQvqjAGUgxT7NoyY42bJjkUR5A5sooMqE76RoxBkCz,true,293322096,293322102,6,1727896619,5481
93,3hqxsM6PP7jQJvb7kXqnEewDirDxMp4LTEULuBFw87LjUmfAeiT2bCMkjpYdUktgntNwsp1xkEbBwpQa9fP2bj7W,true,293322096,293322102,6,1727896619,5533
90,4NNA5ru7a2XcW1Wxk7BXPT1Q1PpiRCY6U63hcMJ3JUkXv2NGaF3szghcax8M3znHMKk9W3WwBEmdsPLkb1Pib4m4,true,293322096,293322102,6,1727896619,5490
96,JJzAhsYBYe7PfBmzvFH3ThNi8UWjaT1L5VK9coidQjef9rsQGK4FaSnuReRgrXiKWyKFBMTu2MSBYjcXkQhxJe3,true,293322097,293322104,7,1727896619,5271
97,62FMGgTAUAxLJzToRj3sH79n3f8EPdt2gw4AmiDwy5ZXMEvTScQ4qW7nucPDPHpGth8TKK8cNtJYJy4QRLLaYZTV,true,293322099,293322104,5,1727896620,5170
94,4M7KxogGJzQVVJehbsbW7VLd84xVnhYvJ22jCUDza8Jm62KuCT7yMK9Bc2xKPeuFjgk9npze8kohcxE9vnLABULt,true,293322099,293322104,5,1727896620,5186
92,39zPzEaekZTCd8QZKW5iLM5eGESRbdKMSrbd2PTJq3C4YjPMA3ViizYVYNyH5fvkCMWgv1JrgEK3csP5oRkRJXWs,true,293322099,293322104,5,1727896620,5550
105,5vKxHE5pXfYJJzdQjQ17Mn5RHpmSNPQgJ8E3otit1QUEFUBdjV5P2yNoVsq96QvGFhVkVo5r6UpANHRsbZKCC1Y,true,293322119,293322125,6,1727896629,5168
101,3x4VfDQVW272WiNcdRMwJ2ysR39v3YTQrvSu3nxoLEmCua3ktcmKT7NZSBEZrUvNWnCbtbcxJjptBj1Mhk3kqhw3,true,293322119,293322126,7,1727896629,5291
103,21iPXAvaDeoUWmBXLkiqHkX2gncDYxJNABi2hozRC9gBm9YmrVHAUZhBfSkosoD1UbjKyUBWcwPcYphHZKjDQ6Ko,true,293322119,293322125,6,1727896629,5277
104,4Us5SpQRayWmvdRsyAyPkdeamNH9aSjvs4GExNHfszUdPowP4C1JD82GvTiJ1goMgU9JJ96hvJt7945iZo4TciDU,true,293322119,293322124,5,1727896629,5204
100,6uUg3GVTUowFaKnDcWMs3eKmQzT33efMUfzaTLnueufieDijvF7qF8aPsobD6BXG1mNpxxuZ8iJ1FnWADGoHVpu,true,293322119,293322125,6,1727896629,5335
102,4tPPxTaJKaKa8zCuyksgLRDaBp86D2aN2TCqtEXjEB9ieftmqZ8ExMvixv8ZW4GK6PjCmBqujkGLRPBBVvAnWetM,true,293322119,293322125,6,1727896629,5307
106,52bQycjG4Ge3nmibnsaUiRHo9XwhCdBXbsVwmsFyiWawWQM9wxaStuxiY2EcuASejVidSLpYJTJjrmkFJasLVkVD,true,293322119,293322124,5,1727896629,5463
108,4umAWkWtQaKw9BNq7S8BhVvaX2CyLbe87XykbKJqWe9XmmU256mhXhjC84tdPzcmc8Z9ANZwZHyV1eT9ex5X35j1,true,293322119,293322125,6,1727896629,5215
107,nMyLFAeDATjSXfwS6K1sKvUKidQEsmwjtXCn3etF56XpvwdZfJctixKQBzmiBZfo2WuAJBwdYCdAx3LqGHdt9qB,true,293322119,293322124,5,1727896629,5460
109,44banzeX3BNJpMgU8H7Z1rHT25h8K5Tu422U5oSv8PPMV1EDVJTHU3fJicuT559n5sXtZjaPNbSk9QTAyMeC6366,true,293322121,293322127,6,1727896630,5276
114,3EHKY5uvRcP4DgVhLX96bWDCRjeUy4jmVpXp6VbJtrfbjBVL6nheWhpZ66VuM5aVVSViUU8o9DuWEKD68Vo7rhYQ,true,293322132,293322147,15,1727896639,5188
116,3LDXH6kjyyyVaD2bB9ZBjbK2RD5Yu3gqmn3Ypp5v1NRi6K5fYVuZWjYEks1BK63FT9f9iN5nvB3fc7gNN1kN9ffi,true,293322132,293322147,15,1727896639,5204
110,33oBri1a44vtrjMB4UQZ3CbNzZA7AyVzgAxJH5qaoqB7DZyWAKsqxRBXB6obueU1BzPE5PLbeC3uVkqTYs7by4EG,true,293322132,293322149,17,1727896639,5205
115,KrQuNBM1STVTtGnZZz55zxaoNEdFXAjPLLqS5Ag8SBxhHbYdzTSi5zRtswxsAA83MuxxnZ6mRMAkmKYBaLPFbjE,true,293322132,293322144,12,1727896639,5201
117,5RyjK7XHiaqUgZhzFFETiB21X6Tr1mstcZqacbYXS3njmHQWUYJb6E8Tsp1RWwMzCT2h2aJSGKRfnFiiwnY6KxVo,true,293322132,293322149,17,1727896639,5230
118,3z7hcsuiUBRzatccBnnfg6QhYnwRJYcM2PqEMDhvxfjxUQDovi5yScjMz8Lz9CYY59pioCFy82S3Nvz9ipC4qjwN,true,293322132,293322144,12,1727896639,5260
113,2b49JbrP4sgbAKBL2pPwHi7reB6Nwkrh8Jc4tkv3u4SnpeKMEwoMuYLPMH8tN9Vp6BtCd6T2b1ipmDQbdvg3Zece,true,293322132,293322149,17,1727896639,5376
111,2fscLv5pp9ZDCAFoLAtRPeSmVdTY4X1vjncHa13CExsemBkTVSqWJVDw3AX2tLYec4S26HHdoVT7tCE6z66irYex,true,293322145,293322144,18446744073709551615,1727896640,5186
119,2rVSccN25gwwr4gk3Mffkd6kFuS6ZoN54gAemEhRXB9qp5f9Na3fe3ZN85iaFaCjmapV2nmuX2AAFyvYVXSdxFh3,true,293322145,293322146,1,1727896641,5256
112,2MgpsYz8a2f2rV4EudmzHn4fAM5dJMwFruGN8GH4H5HH99NCNnWKw9ccD4iBZ8p4a18juXW4JTYp5J9ozr8WQH6T,true,293322145,293322144,18446744073709551615,1727896641,5507
120,478JdtvQKPJxSVM2r3ZBDYfRXcM8zUTh3M1WcRqCQYHbkY5XtNhFsusjgwzhEQPbewmX5CPB8PiExqDgbeaYxto8,true,293322163,293322165,2,1727896650,5204
122,42Mietjfs677tEQSri6o8Cn2BJw7dkw5JP7zrhgWmwKFC3M3pncNEhjpEzqkupypEZ3gbQg9vjYWiDgUx1vLUvjD,true,293322163,293322165,2,1727896650,5236
127,29dfhe2r5h32Ge7Lt7HMZi5U8LeQrMKfMSEjahmFScoU8o8TAUyjFrzsn9CZBFVTTSpjRR4FRkcSZyTtWa2Y2FRg,true,293322163,293322165,2,1727896650,5297
129,4pKtANNN7rrr3iVuBQzEm1rq3KTX7tQRgfacnD75ktYUnupDfHz9rs5M28fu69Sue4k9YxJNtGfkV5sJJvyYhYfe,true,293322163,293322165,2,1727896650,5277
126,58ErvfN2pUGzuJTBFVpdZca5UueMsZgMA5z1xziszSUXfdNxnzDgqrGDk2GvyypGNLpPHTmFVZ7JETz24x8GiWm3,true,293322164,293322165,1,1727896650,5155
124,2GSNNNLzPfoziagDzYMVEFpC3VmpozfrDM7gmgr1KzbAqjGonUVyDoGULBGqXXThp9YDUC2trWh4Lm83aqmkRpTW,true,293322164,293322166,2,1727896650,5191
121,5SQUeHko2ENmaxa2pEEv9H6zJPvV7rEMga7hJsTdU8Wbf1utz8ho8Tzeh4FeES2iZgcW2Si6Tss2gifcGsENhLRw,true,293322166,293322169,3,1727896651,5189
125,3DGXZ7epQVWgZG9vvmA1Wa8Q7eJe4YqndEpoE5HcqHmso6KWri4sDFL6tSD5UUV6G3e5ZxP77svgJXgnHC9EERh7,true,293322166,293322169,3,1727896651,5188
123,33ojMuaAd1QVTqqo98qLCt6bnfuyfk6CMGf94mvgZQbXgMHq6bNfCixPReNZUK3ZCwsnEuSqvRchStFsU16wqc3p,true,293322164,293322165,1,1727896650,6662
128,4LiJNkUgXVTtVSnSsCaUnMeAMqoUEyj32PNrL58hhFzwnjQvAEne4A95gcwzmdj2go5TXKqY2wam5g8NKuAtL1wB,true,293322164,293322166,2,1727896650,6704
136,2eY5PMuXCduUjnrRyqEvhAxd2gZ9CkNQv6U9xHQndCde9CH52EYTbSXSM9idSL3zHBUUnrE1oaSChfWQrSVdAsEi,true,293322188,293322191,3,1727896660,5213
135,5hWEoYjYRLqVNpPRyFJRwoqtH5jqSqp7mUoNoUdUHxb2A5qCcbMHEGX6tCFB2QKJF2mmQRg6JUNh2koCVPfmKWhU,true,293322188,293322192,4,1727896660,5171
134,2UHDB7PEM56bekckMhwKdJNGF8z94zEsHd1T7Qtc9vRfbmr1zNBHQTDkyoVdkQqYwmhARhpaG3KCA678hdUtSrPu,true,293322188,293322192,4,1727896660,5204
132,39z4PPSh76xHopeEyPGheHKjwywTQBG42HTKoM5vh4A8KWaa82V4GndKPoB3VHWq1k6mqCvajS7tZuk3eoPXuNwP,true,293322188,293322192,4,1727896660,5196
130,TzrfeQkuYvAAJFxpyhk8SCGuBjacUgSCf72do4kLCxQQ5gJ7ADo2uHFQ7GKW7tbFMwvmoJitdvF9jftjA7pB6uD,true,293322188,293322192,4,1727896660,5323
137,33VVPNGWXJNxUWdGwgyJBeraULgBCFGsqhB2f47DgkTwvPNb2PJbCavtKAYvdCujHB2t6vseGxt1wporcrYSg7V9,true,293322188,293322191,3,1727896660,5453
133,2MXTHr3dP3VuvrFvph9drPfPbNbcst6YMqLe2xMwXteREm8M2GK4Rfn1krJPQoAcCPeT4x17w3zjDrveA5NAJf4g,true,293322189,293322192,3,1727896660,5283
138,3mMvXvmx12vSBjj2kLu2Vm6N6YrKrQPzbxLAtSkbgZmmFrXf9N2rxL36URaFqwC8TSMkK3uDSRnij2TZTK7Afq7o,true,293322189,293322192,3,1727896661,5279
139,3mRE59MSwt5BJTuKRSWJo8A4Fb8eFcYwKgLVCDuETtEyBEDktPofwRTMSKrDs6xr4pu8Z29sZhJS4uSwQFkRERKi,true,293322188,293322192,4,1727896660,5445
131,3WK1ZmnKyrLQxAhFMupgzjKrgkapjQBBPeRCoCL8S8LuKLetaaEF1yHcJkVNn4DWXuV93zaBqZPYKWYMZYkhXBXA,true,293322189,293322192,3,1727896660,5473
140,3Jwjz2bZoUdFwEmwPPDz9ffdkbSpSgxwu2M7b3zEMi4CMF8YLxoz7A1kxTtvEyf4Seb6jU1pniKjPnzBhEaPBvWo,true,293322214,293322216,2,1727896671,5208
141,qn4EQxGf5zKoozMdPgWDyMgymCiU73m1fwMA1Cm67GXFdGW9P4hpdNXE9yytrCUxRMjwU8oM92SKsdCfY72QLvv,true,293322214,293322216,2,1727896671,5269
148,4KBrXBRLrKBZ21zUR3uBmrYWG2kiq2WWwTgfqDtTy6vFLiNNp5CynV4wksQfSq8pfhhzGtiVxQ97Ug23QcA3zYbH,true,293322214,293322216,2,1727896671,5273
147,45GJdUMt1G7YzA7UKhv6A5sZvTKiWJeAJbqZZtS3nWE8wFv73S3f2AquYshcMqxGDgpKctxdfPtPcREEeE9cc18F,true,293322215,293322216,1,1727896671,5267
145,2o5Be9RkVyw9AhLHoPTk2TjGzgW1nedXYR577yQNmS3jQhdAwC7dg274ZcHcNsYcr7dtFE7NXzxawqygfhymRnrN,true,293322214,293322216,2,1727896671,5450
144,oST4mQDFHkcWkHK6rfkFn5qEXhw1u9679Ma9SvycXpfxyx1DbfNtV15jzKAUwJJfmfK5kYTT6gxtYzLk5RRE6FY,true,293322214,293322216,2,1727896671,5486
146,53T8W9CR8n19xTVGycigVcEjCTZtX3dJLuZscM9aKede42kp88o5wcCaXKPCTQpXM8PaxQ11M1geYF54a5vbsti6,true,293322217,293322220,3,1727896672,5200
142,2DroLMnirAQ9Tm4brNS2SsTM9rps7q2s1rVVSno7c2xWpe7SB14wMf9gaSuBxguieAfb8ftrUjaDxbCtJ7gtXwAn,true,293322217,293322220,3,1727896672,5296
149,2CY6zzouofxNjvi9BCUamfLCP2Ve9xL6yL8RTPwN2L1pANsZppD7gky6RthvwT1QRetv94rPLTu5FjxnLTctYjvr,true,293322218,293322220,2,1727896672,5191
143,3Gz9Et1BCqZGtq2Uwr7mpuwYAJgfQijJVVcTaDfETWGnF3RQTGh549TkT2jBnFyGYMshgu4b7ay8knrgd2ZH7dyX,true,293322217,293322220,3,1727896672,5523
156,3khGzVCEP84RCYgP7gPUyStXCWWGfvpNMo9smwKLBEbNVc9SNr8iXT7mmVb3fogHDBkdc4nwcixH9crxhzbfJn1d,true,293322239,293322244,5,1727896682,5214
153,XFaRPViDdSLLbGVq1guSXUATgP9VMJCevWashfsDNgcr2h55MakNgBbQP7u3MHJT2XrzLecGwocjmaKXHh8EU8n,true,293322239,293322244,5,1727896682,5200
154,4sCV7TEgpZqLcKiW93kaD2eVzwtbWzA7Su4hS2gd4hYj1GRsXYPmDj1gr1FWc9ssPMeY4Ay4AhchFXRVXSRbURAD,true,293322239,293322244,5,1727896682,5310
157,37D8Hsbygb2pVtwpTkKd3d5WTQpcvhMvvjrshkN7VWhvjvj26dBcDhnMeVSQG6fTTPG9QyhtTcLnVcAvhm7E4RRp,true,293322239,293322244,5,1727896682,5156
158,388VvC8zccds7gFsXUzqtxKQE1kWN4GvoW6muybCKG7auvHdsDXHkMGTpmyQ2Hw1UqGWhW8VjkCHEttstG6YkxFM,true,293322239,293322244,5,1727896682,5285
151,2buEej4aHsKxqha87LFFgCK1TQoFUwWobHRhJoeXtzfBLFKo2VMtAfkdUxQRcjaMLL7EqjKVEyEmJji6WCH8RnUk,true,293322239,293322244,5,1727896682,5140
159,5wYbJNDNoLkJecFpvKBsEH5gHv7Br8wZwZUV8zAFGLqzcCDpnVbXUkdCLKrX9bicsHYEK997h66cF7z5sjR8wqbt,true,293322239,293322244,5,1727896682,5374
152,2VRbw87Kx7xWDEXoQEFoQcDwzkNudEAmDJhtQWuhihC7j5jrFFeseJLSYH5BXYAcAphbqipNbBhv5dEFgz4NyYTL,true,293322239,293322244,5,1727896682,5443
155,4KWoNeNobBhbmGzt25k9oFkuzTLkinLjFAXyTRqRz32AQScnhMKCitzM1UVdK6Y5yVx9JSsyHKXB7gQqA5T1fHAG,true,293322239,293322244,5,1727896682,5430
150,cfJhi4LKZqwtsVP7VBvUnvH2VsoufQqA9J1YE6dAmALy2sVbVJNm5dvyPaj12mkmoijSUNuWzQngmBmCM2di9mj,true,293322240,293322244,4,1727896682,5140
=======
5,5o4VsdFnHqDGovg9J47EujAYZ9AM9LGxbWy6S7BW7TTK7rg7QeNu8Sa7SHTVTpzkM7ZUkFfujAcEPMUx5aTPxeiD,true,293304627,293304630,3,1727888574,5261
3,5DR6gFzT9R7buL8m2hwyX6DuvkTXU68aNz8Dghr9UdWaWCejhvUGYQ1irEzRDLWwajJVN7RcTQMQ9wfYFi4whaMS,true,293304627,293304629,2,1727888574,5285
7,4sZzh863xbh3ytB4FkVh2y8C8ZpN1Gg1iVqom5JCMm6UKetjFJbg1f2LWJ9pqNsMnLZKKZJBkwWb5FrmZeuUAJuA,true,293304627,293304629,2,1727888574,5322
2,2KVnBbAZNrhwXTt1WCxf6c5nvaB58E6aJy3UTw2A3UdvEWdmbvZ2zxjY9RLGDWrZcPNf21g84m9cyTVcfuUPAS9C,true,293304627,293304628,1,1727888574,5430
1,5ijMUEffdU9oqDKsmkYLDXXREFLz4WQ5CrosPWrzkYhrRn3PgYUhrTFLxH66LBrq9KxD8zKaD4RR1qS9N2J89bUE,true,293304627,293304634,7,1727888574,5375
4,4RJH4B72FqMGsJtGuCEe5wBPcf1FsPR8E9uZEcpouqijgqk9y1QWDbaW2je8JQjGCKTXREvJoPaq1LM9AApo75oU,true,293304627,293304628,1,1727888574,5352
0,5QaxPtqeXrBQy9afFsYpSdRufRUFR6KCc47WyhZENKPXJ9yfWNvmk4RnWEgTgVgfjvRNsywVrKpRRQcHBitC2HSd,true,293304627,293304631,4,1727888574,5541
8,4W9f7bWHyZGwLJdwRd9yrakwBtEcRV29QRxVJ9QMLMAfwjtoKtvfD2saHQYHnp5tk33kMD9apaARYv15WNmnu3Vr,true,293304632,293304633,1,1727888575,5281
9,45aopMxkzWGTkwG4JAw8PQCJyddYp3Xx24MNgUAJiCErEYwFbV2UDFSkiXgCppgcumqkrzbLhTM6D87iCAd78Kk6,true,293304632,293304633,1,1727888575,5263
6,ZGx9ENPsBUyXn7kn7Eun82hqhUNEDyBQ2vQdCStgkos3kSxeMrjEbaNwkSTusGFNq27ZnwFX3rZvyRzrLwSc29K,true,293304632,293304633,1,1727888575,5343
19,4FgQgVtKDDsDkA8xF7yfjSmE5L9NLhrCbpQpUtVK4x39YuZSBBGms2fgnYQc9NqReL8DfnxcLY8KtVsvpMK4h7qS,true,293304655,293304656,1,1727888586,5615
11,3tdvyC9saGXkHRndQ2ZCs5SdCKPW17hpvH3kESvwppFbdPUa3mNnLx6Y5yo2gmPBXbDsSexchq5NpiuuqvnFvsBx,true,293304655,293304656,1,1727888587,5669
13,Cw2E7kTsYSmgpGUGpcaNuWB16jXpK9K3eHRu3fGcJb8jF9pyKZE4bPQz6cDjCwvTT9FYSNHXxLLtiroKqcEwhFc,true,293304655,293304656,1,1727888587,5512
12,5fwYAKigT6YqHoyzyv1cAZdvPzBqa7BALWrMPoV7pyEFQtDJuk3veAcpoi6ugmtABBPukHeRc4GC9CotuEanhjYo,true,293304655,293304656,1,1727888587,5669
15,vKo6x1LFkArrAD6zh4c9Ld2fyEc6FiXYSkMktPs1g4CZMAHTbcyDa5oEd83o6ypqbHhfpKTczWbFT2CkBLrt6LU,true,293304655,293304656,1,1727888587,5634
17,2yH4DTjYojG7rY24meci2PvNaDEcikJk7wy3b3YJPaSwUUNvPq8s3dchZgRqb1hjrKvjLbdSEL461Gdsyi97EHYU,true,293304655,293304656,1,1727888587,6064
14,3uxk5CJZZ4v3fR5XZEEYYu7yHissmjCbBaeJaL958PrwDGRTRF2hFyXzTDHC3qjHCYKR2mAJrWSesePTuAb1QmkA,true,293304655,293304656,1,1727888587,6024
10,5oVvuCoXr9BSvTUuwELecUbWtoPN7jMXP2XJukk8EM2chm6L9zCLyhgL3GatXXTYzLYGe2tQpCd3p953wJgSrdhH,true,293304655,293304656,1,1727888587,6399
16,3qs9g1L96gAdz4Xv57pUyn4vsWqfNf8ywvnREyzyN2SPSvNS94mnw6qhXeyyp3PnY2jT8vAci5AHpwcS55CMP1Lg,true,293304657,293304660,3,1727888588,6217
18,hi5DJxFSS46DvngDNuZPoXFKi5DDRCqYhiH7oo965MqMRJ833TwkFJ4MBeL4KEjojonCng1qDKt9RxLDzxfkHze,true,293304658,293304660,2,1727888588,5866
29,2tLgexvs5mzLyogpeoLVQAuLxbaC9wDKLmqurfTMJ7yLwEi8fMt3DJ7pD6ZSoaLXPCVXqzQPPxgAzBCpB4kcgAbj,true,293304674,293304679,5,1727888596,5169
27,3iuoM87Khv1xT1eeBkkcwshvZZi68VdPcxKrz9YF3p8Ebh78i7qv6kWujfXuzmwpfGZN2sJjNPH3N6XFL6hjoxMu,true,293304675,293304676,1,1727888596,5254
23,4DFs7XXhdy1TdP6uNxr5iAd8nwRxXsUKmdXQTXLA5nvp5w2UEiymVQF1nVDxp78nbRyy3GjtfnEjrYCWcpXqXWhm,true,293304674,293304677,3,1727888596,5816
25,sg2cDHjUsp63w9zkWq7mC6AnHdQ7WRCiY73iyMpHG6HA3d9XU9PPTmVvVRPTCJKwCQ1MJiF4VKVdEeNuZBCY5as,true,293304675,293304676,1,1727888596,5621
21,34S4E39antKFLsi5Jb9n7Pd8dCFXccxvHBT2sVhYzyyCDDP36MNjeUoewocuMSvC2ZiK9G8B1Y8UhH89hkRPsWA1,true,293304675,293304676,1,1727888596,5517
20,63MaNQbxm5XXS9NsyfqSCdusmJcFm3phQvZPSzmGcJjyydbrSyJG19Tr3dREzC3rHfuzWQJQsbGGiQuAPirr1wLs,true,293304675,293304677,2,1727888596,5545
28,4vurLneMoWU3poKaCZK8KbJMBr47ePhY8mgbornp2TxSGx7Jr79CBjfhSsQETWqfFYLVm4uVhfHaRQKn3V8y8r1f,true,293304675,293304677,2,1727888596,5805
24,4ZTA5pfmgo9n34jyAsifLhrmrK6q8fqHbhgSH3B3aGu6mLcmhaUtYphYmeVW2QSiJaQixVNEc9pimjRxjsUv1YXj,true,293304675,293304678,3,1727888596,6123
26,5pz8x1BhYnf3x7eG59x5ptj2ntQj7jmhmr28TL461z4MnpxgsindhjC4CN4gtvus9xNbqiQJiA874YjiLJv3mgfB,true,293304675,293304676,1,1727888597,5593
22,3LiCSUygPU3pfuogRb1TXbVjte2dPzyHCBDLdzDGdrkfSCH1KCgBppenqzKrsRTEhqtnteScYx7bGDNq1tdxgoDK,true,293304678,293304681,3,1727888599,5714
30,27pME5TPyjwTe3E7f42aeyYYGppbKBNTsjFHVdHg1NX8vmwkyThTg31RHSqZA92M2jsVeEZN6mkbzzaSHa2x3Pne,true,293304697,293304700,3,1727888608,5192
38,43ktejidMnWA1CYekLPBNa3UQbKeVtugnhZQo3T8tng3nozMZMg4fKAzLsVH3bPs9VAE1AFuFPQynBnWaVBk1QiB,true,293304697,293304700,3,1727888608,5520
33,qxxPMwTbMang1niVbZ28yFAuegcQcpd5UDE6FGGwyD8UdBc4uBGyuGLqo5c4Qqdk6zK6raZ1nxUCjKAEGHGCGv3,true,293304697,293304700,3,1727888608,5505
37,5a4TV6EbPtr6u1sf2qYxrxnZfvByLa3J2y9ajwHHuz76Rg7gNt7QpwNTFvF6AvaTY6o3bfo61EP12XMSbc1YY5Nr,true,293304697,293304700,3,1727888608,5519
32,3EoM95y61MJCJwjTHVj4koPYqvy2zv7SftqEHs6ZZKNeto2UWyQXB2A8J8KBzAtjMNHz8M7g9uZB29thmeeh8gjE,true,293304697,293304700,3,1727888608,5542
39,58G4MPrx4xNCfxAyLs6tX83s7oQvAw8TxJ53tbPK4V48njKbZrApWkEyRkaNiH4URxjj5dz7jGvQWmy8cKGmVfrS,true,293304697,293304700,3,1727888608,5511
35,n5UqJzFYRUKN1nmEWmLePVJxA753yPzLpZJWV6XxduA4GjJU2dkD1JgQTRPvWux1H9pupMYsH9EmtAAVADThE7u,true,293304697,293304700,3,1727888607,5901
34,3gosc9ZB4dW5UdN5v8mEsJqCMHGu28jGroF37GyripBjK34vsruvhYP6wVxKJYFjsr1vMRxjwAavkbPfaYcy5ys,true,293304698,293304700,2,1727888608,5458
31,4WY62mF1e3YmXAtvAhpi84XGyyx6JqM4uiUzRB69mdwGudwm1Z2XYk85tCr5YWX3VuwFrBgYThqoytaGjFG7W9YY,true,293304698,293304700,2,1727888608,5814
36,beqBhGJ15c2PmTmGL2jJPBM4Kg6XGQrbnewLYQhxgcKpSK8i8PhBnLPtJKbpWe5ZrVBbPercVbfLiba2mQy8HwD,true,293304700,293304700,0,1727888609,5589
49,2wY5PBQe2Lff5QYm8mgLjVrZSVtGpoKioD9LHq7Am18iVofACbok3QdztYfvRApDY6suW1za3yzQzzKWnv5DD3Nb,true,293304721,293304724,3,1727888619,5178
45,5xGqcucRxXKp91ySsko5EKbFm5XTvqhfuQe1HNQKnvCYkTcC9cdgKFXtBs5mpvv9ZqwXa188YbfXhJViReQAAUjd,true,293304720,293304724,4,1727888618,5642
44,4hxJYwjiDaZe8KFo469Jm48p7EicdvUhXxXTmM4dKbeBHaW3GRLR4WU9AEsEJBPvNZEErTjUyQaPvPWqda7uCV1a,true,293304721,293304724,3,1727888619,5373
43,2ZaU3fEwhTm6skTHvq1Rb95oMFoqpyVvAgUtzwr6KhDqac5TqmXNyXQWBv4ff2WgA7fVsFRqNd5HRG8a8pVYz6D3,true,293304720,293304724,4,1727888618,5929
46,3q4qZbmjN6EUQuoTYnj4hEvwT2uKmBTg4AfABVRhWiUeKWpbiJPjcADRQcgLwBBzsnygf3CN1u8DZWEjR8TNAHmX,true,293304720,293304724,4,1727888618,5947
48,5p6wjuJXXxQjYE4QvpVs4QQuh35rdJ2P4rXjbvNqwT21K8ztM1ZdLGBzjEKQwQN8V9Tsjy5eXTgyw6PkVz13KxTs,true,293304721,293304724,3,1727888619,5643
40,4Da8tmSUaCoRuPijDsWuNmxUcK3vedg6629qjpBNkzG6TzUcP6ncF2vfTatGY38muXyVzYy4bq5EAEnzwHT5pSMd,true,293304721,293304724,3,1727888619,5687
42,25mfLPxTwAWFQiYpcWoan32QSMi7tYCPGJK9iaNSCpcLCmoxo8D5FiNRxSZtTkc4QPsU2NWPBokbfQsuPPbfVdGH,true,293304721,293304724,3,1727888619,5649
47,24bcAPpckmw6Vm8TcsQPd9QBWeUUF84CpcHxphJ7RNf8Ndd8h6jVnnrse3WdjeVdkfg4aNbjcCdJpPEMLsMHeuZo,true,293304721,293304724,3,1727888619,5885
41,4kKgNVpRZ2K1GeqYHcV16xvm69Zztgwr6d3PAUdHX6jtuuz71MoU4mBAcPG1k4UFRJYzzBUiRKifp1vSeCotmAtg,true,293304721,293304724,3,1727888619,5979
56,5jNCVRRhm9vqBWQKQzB2zygVEAXhAMQT4Q2pQ3y8hkwWmZ2LtDjFg9V2PeBCTFqkKExT9yEUbGVwb1jhZz5KPrDc,true,293304743,293304750,7,1727888629,5466
51,3h3w2ViD2XT6MkWWvpvxcTkZxnZJ9CazhHK2tDGgpNY7z3fYjKBYs8vRcx2ptnn4iRru4eZdv4LeVqeWGRqVr3bh,true,293304748,293304750,2,1727888629,5549
50,3ZpmAZhmb7XM2zFZt2GHQskya7ph27PhpbNDcA4PuKnmDgcfkMihFF5nkePUKxM43w37963gNz5YeMzjXFkyJBPS,true,293304744,293304750,6,1727888630,5456
58,4biDCZEATFnDqoptcNJBhXAbQJDZmiYDNhEPFUMLv5xZBZN3qAHpZTLtzYsbZDK5usb1ZBV2XNz3y8M8xJVCdeKj,true,293304744,293304750,6,1727888630,5446
54,5h7REFiJ22Cee9x3PZAyt43zbUuddmoTfWnpfPfSkMNkFmcnjusasZTKg55kNYhLDSrWnDqyi8haKXM8Mh9GUSVB,true,293304744,293304750,6,1727888630,5505
57,42FKQUiPbe6kozftj92AzysCHYz9uCsm7ZftpPwcg4ydju4tcxKQw7Q8zFepd5dpqtYXxLYJXcbSJ7RnNcznFTVk,true,293304748,293304750,2,1727888629,5618
52,5ZRQF1VqrMif3mtDQU1jAiw6hBmyUQEMCkukB9sHdZtDSPWX2FaHHHM4dzTpfxpQhWxUXyoTCS9AhtRBwcodSJqc,true,293304744,293304750,6,1727888630,5557
55,5T82XUmrPRsmZMEwZZ4cQaqnFq1mCtnMmSy43oL48uTQnx3kZ92NQMGzLVPffbKTyiJupcCThE8xEtyeevLb1krc,true,293304744,293304750,6,1727888630,5630
53,XvkGsVzMssq8kMy98PNnVcEWPLypZSYBc8iNFbRxLMmJS1yYVqhWHs86ibJj7AAx4bf4et1z6vVBAwkTaUjgGA6,true,293304744,293304750,6,1727888630,5655
59,43Tj2JmdSL6QJQopUHzMD1TzYrQrGAmWdJjbUvMinwank2nbX76pxckk5u6F1Ybwh63oDeWRsdvT9xnkWfCVJwYc,true,293304749,293304751,2,1727888630,6396
62,317uUXbyCzsF5bj5Yt9WG59W9UWxZEcTx3zBzywufyMcJc5N1485xM84GSipof5SisJVann6a4LVQqqpdPvEZZEZ,true,293304774,293304776,2,1727888640,5161
64,c2xRkJh9K7jrjvgHDdjVn5r53AapTxcG76dfSRnvUqdcx7hZL8e9BKrmrcHsQcUam2jkXqUfCePuvRgMPfFVcW8,true,293304772,293304776,4,1727888640,5421
68,YW2W9us3dj5LjvFbRYkLqbobowheRGZcMhznytZz1y8X33cx2XQUZHHXWcMkw74tvCqmXsBvzKQbgnktp6i4MXC,true,293304772,293304776,4,1727888640,5452
60,2JbFzMUNpN63Azb2YjdTtv8ThCKhqBEiUzDWiXDUq8ADMkncMkHvJ7PpvsU8USPJMQGxZ4DoR4DhUNFijt4sPcNd,true,293304774,293304776,2,1727888640,5419
65,223CfRRV7uL2GCQU42mnW4pb6jW893gDFn7dAhPpczebeJx3ASDaJkXBtX9sdUkQenFYDvSFTXqrJMy8mqioDVCs,true,293304772,293304776,4,1727888640,5633
66,53u2mZCFyJqU3WUQ1CHWKuo9n9H9N7hyQ9TbEuNygYgfNqodYHrjk7KYa2nKFcga1wKQYbzt3Rw95BeT2Lv9DVdt,true,293304774,293304776,2,1727888640,5632
69,5FqRZZjVhnoUcwKoqC6UGWoiyRbBBww81U516wFWty6QkpbD6R2EKHydFStqLXn9diCUxQ1gnhyAzpdfK7u3W874,true,293304774,293304776,2,1727888640,5843
61,K7KknAnVWLy9vVtLXSH4THmrGvSGXn5MD9yakggzTysAg1QW7edafNPQvcz4dSMspPAxrb4q4okceA6M62nLZps,true,293304774,293304776,2,1727888640,6183
63,5oVmv1kEKRxUR8csBwTzn2igyH1gFPttnWCZdT9sviVs5vN69Bzg82BLsumoCt9b8UDwRy3gAYL1KpVkA6RDAupi,true,293304774,293304776,2,1727888641,6164
67,3mkRuq1gUfBmnzJmqow3MsKn2f5iFfj66CX54kT8b4DueqD58kcyvYYzFDvdGy679Q5YDEBaTyKxY9mt4cZE1utK,true,293304761,293304776,15,1727888642,5523
78,55Vk3vUgeKg4eHGKmGL7s2HrPnkXHBsgecuai8B9b7dYHktD1Nk1161B7pv78miRnANfBg5QkKpoJiwkU36o2fa7,true,293304797,293304802,5,1727888652,5468
79,4co11xuwYeYpDcHF3W86egEbZbhwaKbJAm7WGSodomthCuf1iD33fUVvQnbG8w5Pe7GUthu92Yx8kWEE2m1PEAgB,true,293304797,293304800,3,1727888652,5517
72,4uMKeoKkexB3UymW3tf2MXkXQRiXCAUd71EzGGr8TwSyx5uQk3a4oznWa49fdJ8iuw2v72i6eWBz7iEpVD29eu8x,true,293304797,293304801,4,1727888652,5552
75,2Lucn2fGSLksMWw4mBPSkEoPJvyLC6iPWNYfYYb7GpNzoR1x5yGyUcXWo1acirVSeqD7nhmk9yqzRL93fjrYnLwG,true,293304798,293304802,4,1727888652,5528
71,2k9TsSZPznSyjRVW3E68XTYhB5TPcQARf582ZXY1u3tsZ8VoyGb8GPMVbX3hvUHzbu33ztUCs1RqhUezjUEYYtUM,true,293304798,293304800,2,1727888652,5456
73,4HhdLT89AVZS7RZCepy5ozerKWQDbo9A8icQrYdVAvsV9j68odx392i7HZ3ANovD9nKPZR1M43pJ83b4cGPc4diC,true,293304798,293304800,2,1727888652,5583
76,23qDDiKiQRGKwmDuxJzKy73rNrUfXQ4Qwczy57ZYYRbtM5aQ7KLyUrg4Nn2zHm9tkf939xLVrWKaH8GF4pEYUVjH,true,293304799,293304802,3,1727888653,5347
70,5FV8QJrvhDaj2cUHzax3Jp9PiB89PtMkEJyuoEUshvqCTS6qh1bD3N1WNsNjTExaUQFLZVtySeho3sYmJ3XQTDKA,true,293304798,293304801,3,1727888652,6452
77,dXkyV2XD3EjMvehBjyjQRHgcLf4tHeJwrkqre2khj6t8Bfd21eUH9vTzezdWaJE4DkQesdTYPanN5yqhB6cGK6u,true,293304799,293304800,1,1727888653,6017
74,3kbMseXX383ohPQDuDF8n63bvWF3d53qPBjEx8xj7KqAGWNYPk5kUUpDh9zCC3LWzKYdnUMdH4hHfprgUmtKRZQH,true,293304799,293304801,2,1727888653,6011
80,5GWcV5HPdzsbrW4FvUFDmp6w4txeKpWXY7ry2JnhBigbm1CChFHErCsH3AfFWn1aAhXym2ehrBHaW4muBQUP7tXT,true,293304822,293304824,2,1727888662,5452
88,3S1njmfPSzuKLzpgFFWJ3c6Tn4DCkbfdHY8aVdkcnjvwVEBdjLfscVwDeThKNEs1DED83kzuTDgHUSXEEsN4HZ8V,true,293304822,293304824,2,1727888662,5514
83,4CderiZLusGQAzqKzM3i24kjHPg6oSKKiKqS8VH7dAMMfsHW8Hm7j8Y1Z8393huRzJCqEbA9vHRXBehRVTixXfeH,true,293304822,293304824,2,1727888663,5546
87,5kDcSpANoi2eaY8QAESqAnJ6oRHQonVSRq56zn4v4AMxAozt2HKHdWaukHp8TgRXCyFzc7mkXrtR1sSnKAmJ4UgU,true,293304822,293304824,2,1727888663,5569
89,orvkaFi9VbN4JkbMGyYUj3N9osHwHrBCqeCCQZAEuPxvHjc7yUXp48AkzMfzSrVQTnzRBPGCo6WtjCs9gU4gGJm,true,293304822,293304824,2,1727888663,5658
84,5JM8TgWccH5SRiWS3cgc8kYRLSXpNbLKLUaJJ6DE7xzfsRG1x6ayKq1GfNGh1xSBf7nQeqcnrhv2to4cWn7ZgWiN,true,293304823,293304824,1,1727888663,5625
86,4EoNVP7GcWxbcYHwA3yNphnfaCn7e6RJTewBnq7EMULyDX44u3Lb4yeMwFUfKR3Y22xsQdvYG8of6RAXYC8iYVY3,true,293304823,293304824,1,1727888663,6122
82,25KY216LThZbWULD3Kr8qiVjSFempZwYwLpQqvDvpyNavGjjbGMQ8XZgKtiXEAEfhCM9rKrGJ3SQauj92uLYvBEV,true,293304824,293304828,4,1727888664,5545
81,2SqY4RoDZ1JpseRrRkJRNHuJS4d4g9e9bkv2YtVDaEjU3hT4FcXrzzf2biY3VngrgAf6jahtLRLM8dCMiLJ8rDsE,true,293304824,293304828,4,1727888664,5827
85,3vpaf9UxdVb13K9kLiHhMcHudcrN37a2p1u7EAx8edrziWBBdirRdZPxPMsrCdoFQLJD9xTZcTvo2kUBZVzdYDaj,true,293304820,293304824,4,1727888662,10862
96,5xh8mqGBqiLKeMsGx6iQ16gFmjmsrgirxjrvXVWwiDSRQxfiZ4Cc7tzb46w67BtF7Zd5S1N97XXdi7YnuaYnWqwF,true,293304846,293304849,3,1727888673,5307
99,32837jjEXEGteUefsAcoHusFytjvvVZ2S8LXJNWJjgTVm5Xv1EQ2amb36BZxgqVYKP1gyEcjYAv1Km1SdZGPjU9Z,true,293304846,293304848,2,1727888673,5334
93,2sEXcP21fdFNxbgspeRYGzoa5jamUpuFJcGfCd5cPtZgtk9KVjSvADcEQsRYdVesAya26HTNTak21fgV72w6gH2n,true,293304847,293304849,2,1727888673,5249
90,3RR2MEVhu4NpwTrnAR2WTc9YH5xwtfhGa1Xe28k5zibU8ufbCYjhicJhvYAW7r5HTFRoob9CSczgAiPbUh7ZU41e,true,293304847,293304849,2,1727888674,5261
92,2PFgfw6MTPo4BKswgZjUXXs7dhKxKMYjxRknLvfA5rSYwLyx9At2kpcNqEMEwCoMj5anUT1CoyCdnT4sdz3UjL88,true,293304847,293304852,5,1727888674,5254
97,52XJBaDfo4mgaZUr3Jh42zTymJBsmxNcqnWLGcZnZLaptRh9jMU2GW1UEgRSm9tL3wrnJtMMs3HSxh2mjjXFxtmr,true,293304848,293304852,4,1727888674,5300
98,3kByF4cMNd21J3FarYsQ3GcCTaAfww5By99vdbof8Bxz72uzJRMQzvjQNrzzxqx3jeqg9hPdeHNcnZwuCrXZ1gTe,true,293304848,293304852,4,1727888674,5391
91,2fTsAhCaSr3szFPtu1qpCx9sCkWUjVnzaC3prCVvZqNymFK7H2T3fK1zWEa6faAgKzfhdzDps6a73ErDPNDSrEri,true,293304845,293304851,6,1727888673,10511
94,3FRvnEU7MhRXxYWBfbtNBZtb9XiCgeqQf1hVdxEqjBHxtiDoh2PCiG2QwWqC3iHepf8do4JvWpzaQEYsVXuNBw3M,true,293304846,293304851,5,1727888673,10755
95,p2d7Hf2S1Xc2FpNBRFXcnrvTzPw1f4u5LViocto4QRxCMxKXSjpj1uF3yqzCMwVmUoz83hEXPBZfHsaqz8VHpoc,true,293304847,293304854,7,1727888674,10672
103,Sygv4uuQwYKmhNw32qYWBGrqtN6omGTSTLxP7ox3EUaK4FezZRFPtfmbc7yLEMwyTj7sux17QXDJJzDWwRyHUUP,true,293304867,293304868,1,1727888683,5299
100,5Xi4C9H4LLy484uH7M8wdeQ9zqnQsTotjzedSpXdfe8R5SKjWyVjd1ZHj4jRQKESLTryhLFrzRcsE2Ep6PePUEin,true,293304867,293304868,1,1727888683,5330
106,Qwdv5zFJzqVykp7zhZqZtpHcE36aRGnA5LKkdxe3D3e6YefHAcPtUdeeJz8BDXykJ2NRmJsNfsyAFzm1QaKtt2j,true,293304867,293304870,3,1727888683,5387
105,3gBe23qhrR9sYRBm6WbVvjuGoFhHNp2EimbKoLSe4zUEN9mohhydNMm2F5VwkuX34DXUucrg5otKrCj5UcC7tok,true,293304867,293304871,4,1727888683,5388
102,5j3ctaA2mAgmhY7jZbYUShga7UXqTg1oaFi2jJDnwE14e16NpFSBUTRhSqXWwN7rqaxJBNGsAnXSa4v3rjRbC7s1,true,293304867,293304870,3,1727888683,5297
108,3mWXdLXb8HsXAm7LnRSmaGqGTNwGJAZaJkgmWMU3YXc7bmMfzCcBFiBKzmBMtAomtksGfP8mdhR1DjbwjUiVpNoh,true,293304867,293304870,3,1727888683,5403
107,5SfYmqEdUaYZ47bn2un1yD4uBeXyeRXYfjBAZvXFcbEzJuv1ybR4Yty6s9bF4BcWGa3YXPrNs32XzDeHXCZxHvgK,true,293304867,293304870,3,1727888683,5369
101,rGBWLbGEjL4AkL3ZsXUbHzofv4v7GwyjMxkgea7GjYBvGNTkvMLuYuX156m3bb2FtXu6yTK84EyWa268A6aZoRu,true,293304870,293304872,2,1727888684,5321
109,GpZMFWkHb93sR19reP2Kr6R66YrfHKs81Fsb5G31kF2MDNhXVWjhjWPL9DYXJFmEp2AM69nQEAsANzjV8AzUxmf,true,293304871,293304873,2,1727888685,5181
104,2wo8iN6YAcTSiuwP7MpyGafpEWTUeHmDf2d39eyJpTsRT5CT3bt3RLqEpo1k9xU9Y5itj1c9YsGQxAGJwLoc9CaG,true,293304871,293304873,2,1727888685,5371
114,5MWrGyvff95UWh69wVeg3dtpCmgdBQeQaiQ3An4LAaixzm5cekEY716pQEeKnTvz3q6Q635W54xewJ2FvdB1o15j,true,293304886,293304888,2,1727888693,5368
111,5o6k1rNbGxYoj8hh6dw7KUenQ1PZu9irDiS3KtUKKzNTidw5oCnN5V2b5p1Ge34qYPkM7feGSTQwF3SyyQbdsyTs,true,293304886,293304888,2,1727888693,5176
116,eBEixMgArdsiqg9VtBXMhwtEg4GWRUqLzx4Zavu2bCWing5kSqQfHvsjYWGLx3pxGCdV1Su69tTkf1j8hkfwa6F,true,293304886,293304888,2,1727888693,5301
117,bsj1GFic7SdVexrYpJNSkNdKAvpiNcksF1QcXYCUfTVyqBjdjD8fk3siGsSg2fjyRoZ7jVTS9mn7wNLNtuXtwbc,true,293304886,293304888,2,1727888693,5317
115,nvrVfKikLfjcePMJ9toom91CqaKoKBty7Vj84dHa9RsrdfT3dZ1hFBMde62QhDpuLYtr3KkLxiq6zcBnyTZZ8QQ,true,293304886,293304888,2,1727888693,5276
119,j1feLGEpPcvyVamcFsNVbpZEc4Hdf9UrthHxhgzeXGKUaaP8ph3M4Kz1kjKXWCp18FizJ1BbnY4dXEb4s1qG7po,true,293304886,293304888,2,1727888693,5294
118,P2FhrwTTJpKaGCwo6ERD9q8utqiaw3bbWMDnx8Rc9iENxLKC9qyb5JZnnEWqjTST49mJ4ShDgfpb3CEvva443fR,true,293304886,293304888,2,1727888693,5357
112,63cBKZrz5cMTCtst2J8eu7Tjd1a2v8ViLk1uBhUCYe2DWAwmZkr6fDZATpop2ahELPBpgrurZ2ahFqNyXAoDH5hi,true,293304886,293304888,2,1727888693,5460
113,iPyi2Qw6P8nPTE8GgfLExqAPF5fjM259BHf2Q8V6kx4o3FSaUpaxsdR4jLHXm2wczY2yFZdRH3TeayreFjCrbS5,true,293304886,293304888,2,1727888693,5386
110,2oB3YNtcsbgW2EJMPkW742GYcHKE6CF3yrWfi5fKjMqi1ReDnCu3GACLD7XMJNYSThJ9QVfMc7hQYVLjm8G5oREc,true,293304886,293304888,2,1727888693,5442
127,58jBpQNTfNgY7N5DxED8qiMoakVkxh4DrQ8xFVJj62wDYPvmrZXd2xJaYfg1g1vR7HDrWrntYVkhYJt2uwJCRiy2,true,293304907,293304908,1,1727888704,5279
129,42CZ3nZNA5KqZLdyRiLCWRk33va2DCu7mZ8PhkuBrfz8jhTxQfYgxfFaShybVetsLFS8HeBqssyrYejCPYaMLnmk,true,293304907,293304911,4,1727888704,5169
121,57D5iY1z5zxf3amvZjw6vWE29zQRJRjutaSmmYKk8HMLfP7m8iEUa569QbES7W6gBsLETh3XT3sZQ5V3NuDPkDZ3,true,293304907,293304910,3,1727888704,5273
126,5AiLMkgB61DALk6LBc72zb5ZEmVF3TJmB162Zs8LgnhBf9rY3UZd3EiE316pZs1yBmGs2k26tY6C1GU1aGjRJPB5,true,293304907,293304911,4,1727888704,5209
125,4VXYZZPKBdbSouLyWDy2ysm7nLcyWhL1spc6KHs39YS9da2oXs4Sui8fNuoo8ALvTkdemaVb5w2oq1UQ41nSj44s,true,293304907,293304908,1,1727888704,5408
122,4C3d9d9uKcdUyFQg5BT5eFw8iRh8jbeQT4SXawryfdd171aGaL1ZoAMtdPZoXgcHMSi8UYEmzowVdGA1SGoLcUW1,true,293304907,293304911,4,1727888704,5304
123,5oSKb4GiySpkA7qUsMNJh4ePeTHhSshzAF6keuUE3nKboQryRTQ3fsHChWUtMW28p2H9SJLMnTShUPdGtD3rUaiE,true,293304907,293304909,2,1727888704,5356
124,2c3Wtpoxe86w9RvVJRMKXAHnoTi8ho4LXBEV4JiYcwdgyZ4PcVZ7mjZrqFVZEuGAvZQ2Qx4A3WEtxRxqgsdg1Z7u,true,293304907,293304911,4,1727888704,5364
128,5vAWdMrpMynJLGwDK8n5aMwYVS4F2t2FRyVzRFUVSRCF61QyLkSVbooXNSXVYqvUX9QALq3iAJY1d8ME1Qg6Zcaq,true,293304907,293304911,4,1727888704,5390
120,2mMfbGnLEN8L6g4kzxw5qLGF1cDV4YSUBLYmX6bUV1n16S6Uq3AHXyCZaNMtYhSgvExVPELoF5pLqHWHpReP7Apr,true,293304907,293304911,4,1727888704,5429
138,qedcNXAw2XGQjNEtqSPF4YX5rS3wXA46r6vu99uGzJ4ARVdjB8FYL5aNPCvCsfDqZZh5ZYgnsGhjGb9FbwGUPGi,true,293304929,293304932,3,1727888714,5167
137,hYxbQRi9gZ53P6dnk84Nz9qhaQydYTMgjuaPfr4asCjFecgceGGcdHDic4b2YNz7LzLLbgTQnkr3BjMZMoEyRnZ,true,293304929,293304932,3,1727888714,5186
133,59nhqrDhTe3F6S4DkCesDtqJLvzytkjv2NWidJfbbrnedXSWmYcYbhHPg5yM3r99YDaPckZU7mNimUsPYrTxxjci,true,293304929,293304932,3,1727888714,5289
130,3gUxeuA7nwnNzobJgmLPMEb4SkvJ4pFwhUMSrhMDxNTHX54VzpAgsEiqSHJwfuAXHtqvZeLTt4BdbLTDM9L5gi1L,true,293304929,293304932,3,1727888714,5283
135,RvV9o383XbCNNfCguitaExXPPjEVsxBYWyNecwJU45224FhcLCbdFf7NCVxFz54KMMJt5uqEadBELgUA5cxkjW6,true,293304929,293304932,3,1727888714,5390
134,3m5LeWygCt2ngq5o36BqKkZZAgNQsAYi5XPtvcb4rajRMqw7tTdpYGDD2LpsF8Xg32oD7MFpj6rK5M5vxsbMs9MB,true,293304929,293304932,3,1727888714,5279
136,4kWdR57Yo9Kqa2nUdVBbqL8f3PczeEshUG5XhAucTH792uURCzg53fJFTey2MvJzSPkaqvr35c8K7vQUDkLoaMM8,true,293304929,293304932,3,1727888714,5356
139,guhwStvbHSTMLLsjRN5Y2yQrmPzJhFaYY6PpkEJfUQ7bKfVYf1YC8rKGc5Kc6pGYnFxZqmKMSUzawkMLKxkYy6b,true,293304929,293304932,3,1727888714,5466
132,622ihHbzbcvz6yGYVwaX8gph9FH3URH7ABtAuu7kYxFUb6NCyGun2t8XKe63C3YMsdPSvwdhYk9Ld9Pv3rRBbGk,true,293304929,293304932,3,1727888714,5398
131,233HEFek6bZRaGgFuaRECx34hCA36Z9xRESe1WD5eEo4L3Cvjot2fdKSbjqWM1iujAcac3Vqg18c1D7Q28AzZ4vd,true,293304933,293304936,3,1727888715,5197
144,Failed,false,6969,6969,6969,6969,6969
145,25fNBj6Y8F2EhitPozpPykaFHkVcFD3MnnJKAdScmmoiRs6uUgPjPT1mxFcsopA5d4WAzkFniEBiCEhLX6k34xCF,true,293304951,293304952,1,1727888725,5204
141,2SBUgWkmamX9EhN1sK3u8kXbda3fU4FQG8RCh9to2FDqPcUKmMhUJ9gWAcb9jnw5nrUM325k793RBR96XqfP1EJw,true,293304951,293304952,1,1727888724,5282
149,44aitJtUsXyBsjGSSw6VXMHb8nVkNooJUhpxnGx3PATvEce1oDzCG78wnnWZbAyB9ucQGASkEqnMSbXDipUPnfPs,true,293304951,293304952,1,1727888725,5281
148,ys1MrUeCFxRNFMwNhiruNo84ZJvw7a1Xr97Js2Miq4rwDQZNjsKqwUQEXQerRNxK3y116j4XGMRud8xUxorXK4F,true,293304951,293304953,2,1727888725,5182
146,5RpTLbKZvn6H2AVvFjShPgaDM9ZYN2u8HXXKxmMHRHiuAbiwZRgN9zVoXGX3bGQt74jh16xLjpiMKvLDkuAwYMNQ,true,293304951,293304952,1,1727888725,5318
143,2h1kpBtvgpJhsEzG5efgGmGRLo41rf9G7AnfjXexNGGnxzfgD8zjLe8nrgfScUrpGefMEHveYU6jmgsEjgfK9JpW,true,293304951,293304952,1,1727888725,5426
140,4e2gsFPdtjqbWcdgNbAwbKxX2xRy9CnmTRczcpSRYXoQxBfdp5RxhRmAjJzFch6wwe6reFvCM6ci6drmr8qRTUZs,true,293304951,293304953,2,1727888725,5282
142,3BeqaXwzZ26WChrHj5r6wPWXpPJHxbeKfQztwVnW98yBqWyCspZd9Z627S3hpZpXFGFY19EgFuw9kFX8rQgcCB1S,true,293304951,293304952,1,1727888725,5514
147,3zU4S1kKWLcEpVD6RYZmfW5sw49A1SdzrSvv89UD1R47JFX1Trtn9aQs4yenRe1NbNNt9WFA6PhFwWs2mNhqneRP,true,293304953,293304956,3,1727888726,5295
153,3cAnc9tydbHaR6zunTQv5ciTrb74Spo3smfN2Z7GtST8LNjfMEQbA6AzPbee8Qh9fw1MBA9t2k7EvJdiShkEoQsL,true,293304975,293304976,1,1727888735,5215
158,24cukeMxuYhKy1cQuzHSnvikChM5NYy9SKUawaQKK89QnsDdCcaWNtc8QmUjus5UfYGM27UH7k1k3orD1o7rHpom,true,293304975,293304976,1,1727888735,5223
155,5MNMUuh9nk5jFU946ji1yt328x28vQMagxVNA3YSjL6uZZo96GL5RqwXUFMv5B9agBbH8yPB3Qi8iLmtQWThaVsV,true,293304975,293304976,1,1727888735,5195
157,3ccqs4dvpzggP4fi19W8wxy9ySnLN9FMg9MajuqS3cYFBFdVq3F284CLae9hUguobiyyW4aAFtY6ecqzZPx4GHV,true,293304975,293304976,1,1727888735,5325
156,41x5qJAhdfVVpvuRpF1qLjzf2KfXCmHBz9KrzmjBN6c1KQzh9QbYMGb637PHd3fGdG2r4Vs21nQjrfUuLg6nzzJN,true,293304975,293304976,1,1727888735,5314
159,45aQ9mWLduUgADy7WHb1zadMmSRgrmg95jKHevv7h4PccPFVteKuQCMHzLzmztXZ7BMQipwcWLzxyskQNPPxNFGs,true,293304975,293304976,1,1727888735,5311
151,4asY2zqTPsGwSFYAPpLZkadknFvKu2jjRJb7bxXG6pRSwPcbUP6g8QBszS5TRFoV8N7rUfA6gB65iegfPMkxLaKG,true,293304975,293304976,1,1727888735,5328
154,5VHsYiLReWBKxbKyFytK9JuakzaNWQ3nySe1CHVLmC8baXeAcwU2iAMe4yG77fMpp4qTo5tS18cTHb1yR4TrKoWP,true,293304977,293304980,3,1727888736,5193
152,7MyddSWFZLvacXiGiG3hQ8wKBWGiDc5UQH5J89hCv1BN6uE7foMyU41mFbZBC5A4Q2U8ckMTX6VSgmEWsquYirQ,true,293304977,293304980,3,1727888736,5206
150,3qGmfHnzgUMtNbP7CFmsv4GxbfpPuygbJdSfFS862VpcdSNcs1uZ6hxq6rDoBPemSC4aw3LLrG5HLJLa8v4UMBAX,true,293304977,293304980,3,1727888736,5287
168,59C5Fm2NitmssRru2gVNHmz7m7nAsicg2vuA8KvXKYhve7DUiftum6DP4ZffhzyRinYGs4ijMf4JGdZeRjxCxwda,true,293304999,293305001,2,1727888746,5163
162,53ruRYiqeos65ZcdVtPptB9x1CFawvTbKcD4B32F51124YBPDkC5B6ZGgLpZRZ3aFnRnvY775gWHRTpP7iamNp3F,true,293304998,293305000,2,1727888746,5307
163,5SQT27A4A2fzChc1raJrudbgFf7Nuv69sXva1pWXKsaVoFR4ikWR9NDmYF3Yivo5EHPeVjNTqnd7SNSF3K8cVv67,true,293304998,293305000,2,1727888746,5282
160,2FT3AZSNp5GGUkVHbv5mXgbGLP9Mp9y8qRjW6dj8g9A5UWs97S1yC5QRTVy1MVufujXcZ4mcjjiEguaZQNf3G5GQ,true,293304999,293305001,2,1727888746,5186
164,4jB1hiCTbJGNRVsvkVnW89HHqmdKVZKQ2NLHPPGjyyBQTLBaUT8XA4ximjhuPeZjnFzpfjBhM413W52inpJvZDhT,true,293304998,293305000,2,1727888746,5298
165,3UrYQ5Sodr7wP57xmkr2wJY1U59LzufJvEfsz4Curq8FEvnSnUTTvMmYMyKmtudcSxFt5MfqTSmuEiTZBTjo3iUt,true,293304999,293305001,2,1727888746,5221
166,8no4FcM2g5byyHQ2hkJBrnt3111pDvnmEzph2WsM7fbvC2MsvrTEoTCD2WL7uUKjMyD9AskSrV2mwxHMi2p8xiW,true,293304998,293305000,2,1727888746,5426
161,ZezQLQ21bwwTTFz6j5M8n1odjmv3K9ziCAXE2x4t2dd5WUu5h2xsgRDwvxS9BsbJjbBM44SW86jAFoEanm8m8VV,true,293304999,293305001,2,1727888746,5384
169,3ioZpW54zcswPDMHYMZfQiGwHDUubHyayJqdvByS7TQXFHLioJiBqRPLUNaiYFWDHggEqx5nbD6MS9DqVh356kHR,true,293305001,293305004,3,1727888747,5195
167,5mbtAbfMW5hqoLwgVSc7L6xnvcfCwomQiGjA7doCHq1PJtqRLGeA1k1LPgmTW12R8TQWEpLkzAb46jc9KCm4YQoJ,true,293305001,293305004,3,1727888747,5183
176,3woA1BHonYz2sMFpsCRezfsofGcFRAtAyirBruWWXTaPaLs5VagVr3gmVH4vTqn7syMN657bNW6N8XpWnj67Zakf,true,293305024,293305028,4,1727888757,5203
173,4bKjg9bwwGtyivAEEnzkxTYoRzJjTDcr8EaLNagymVZJjE4sdVATfeG2ZdcB8vT1poDwNi3Gs11URkCEc8UVPWCd,true,293305024,293305028,4,1727888757,5190
170,3MXpfhFLqZw7Cg6gUvyACcG7QcGRMzzcvarB2Xzcuru6j1J5VivdNPmPPYYFQK8iki9zUZ5jnMbsCNTs168nhnqh,true,293305024,293305028,4,1727888757,5224
174,3MMEU2cXs94wdkj15NZa8fFH8EJSbDT8cf6Yc9FHdL72JtmBjssrWMftwkDiQrhoNq11q5Kyk4VaZ3qg8Zx6Zbqj,true,293305024,293305028,4,1727888757,5334
171,3wJEknjgAzUrpGu6YQx2GubzXEvQiHtMdkSobdWxbQnFLdDSSPfg3L2HV8LMjBWDCHK1UfNTFELv3sHLeEakR776,true,293305024,293305028,4,1727888757,5386
175,knFFN92ba2Q7En6aJUtK18Ex8QvRywJNuTLN5F44oyErqu3D3mFW5LZHGF3hn62WHn9oUjap5ufPVA52vv1ci9c,true,293305024,293305028,4,1727888757,5388
172,2xgvyzxsUY1GjBbCeXF8XJVvWM1c8HpcFAzVgkneziqv8kfxThPag9iu8vkXvHnKV5v8qqmbmarJ1usjShsTdgsu,true,293305027,293305028,1,1727888758,5176
177,3vvg2rGFbtAwyGgfVT6tWigM6Hsmc1sJuvRXFMGWptYGVixyRkNUQpMXcux3QyfW9jXRPdsp9KmVRnHaygg2bZJs,true,293305027,293305028,1,1727888758,5442
178,4kY59eNYPuTCfk8WfufZX694cxA5gjrvCfkdYy3XRbypNHJ3ZdWSTcC8wMB1UJdEEbX2ETWTjmzYUmiwGpCW2LUm,true,293305027,293305028,1,1727888758,5293
179,ChbTEvdV5PAp2jTGr6WKtJWCdVLZZVDBjX1GmyV6qu4wbp97QF5atvvXejhz8PUqiRC7Z2joYoHJjATSxSmazhq,true,293305024,293305028,4,1727888757,10546
186,DXmZcwUJW3t7LiUg74a8beHCKwpM5U26C5tBoiNwejm1nQoy3NaLcnWJUWEbPmGX3U8Uyr52WCyosir6M6yPhkV,true,293305046,293305048,2,1727888767,5198
184,3auL51iKAWBoqshNYnhUEv22XrmAkSsiChGcPZk8qZb6AvEDXyKRpL16xsh7g8nUF96MmxUbJh2Ladyh81JwnUjt,true,293305046,293305048,2,1727888767,5214
183,7GFHAQndDgQu7aqYeE8n3emSiVLVPQCUKjqEarN5tbFS4MDA5cUoLSTF2MdaXyxXFSBuUqe6gWeFjeWsz2QBsPi,true,293305046,293305048,2,1727888767,5278
185,2C3ZCwxB5oqgueaEa5pMEvDw7MU67dDuqfE2ioNqz2SRzgYbY4b2UWVjCuYDzNQ7ocFWQ3m1KdvvdWontZGMMYBm,true,293305046,293305048,2,1727888767,5336
180,QDqDMsRtXaxeAMiRah8jeHaYof7Airy9DR7n2MwQ2tBbPtHS53WHC7ac9dVNRh7hc1wRNP24vbi2KDxDdc3ghZP,true,293305046,293305048,2,1727888767,5320
182,3Z8YYYm5DdmZJFWZr3uamtCvazYXySmvcvHDM6aF5RYeAuNwPQCCSn87njLvdkCutvk3fxBG3Ko4LTEQSG4N6G4E,true,293305047,293305048,1,1727888767,5211
189,36X9W6qNodvFoThdp12ciBrBDaNA5iSWUWXiX2Jjfc5oDZEDQW43tfcEzioQJjkgSYEUYmv9YbmBndk53YY4pUaP,true,293305047,293305048,1,1727888768,5184
187,27rdpDY35WkjYYZ1Ryut54vPWC8e6SWodbYYp7asrFhT8BviBCKGFdsT6TnUb4BFkNgTjKAuuim4FppXEchyADhT,true,293305046,293305048,2,1727888767,5295
181,3H8D9Q7BbKVfaPnT4UBSsT8jKszx44NxnmMjXPUnCM71uYZQcA88p2WHjPdtst9npdskw1mcA22jtoxdL3iKXhqT,true,293305046,293305048,2,1727888767,5383
188,4gqPBTiiLp7KpG6qXVw1mYkAJMgLeE7tMgSu9ErnkKNQHTe662Uo4fz6ypbb7xCNQ8iGCt9Xv2ZmPZzyahoiciXq,true,293305048,293305051,3,1727888768,5294
190,3eamyc2ZWnv98Jr6h6ykW89RBfzTj6ZFW1A8fYKTT5wBEQnFAjFqWxn8vXusPLF4F8QZzEJiKLJe8XpBqTdFd3nF,true,293305067,293305068,1,1727888778,5203
196,Z5iS5cbzvSvneZLDVRXcMJtLdqn27tDWfPfcDGdyhxbsncXrY5JkecnLVqrKr7tyVbKX1f16GboxYGMERcRr8Ls,true,293305067,293305068,1,1727888778,5204
199,4V5Bwd6EpCi5HZCq7A6hUbRZDZYz68pLDdPSGcLLnwq1ydyAwp9FkSkNMMz8yHJAemDZnJLLEpvSDgwt8hJLCccd,true,293305067,293305068,1,1727888778,5284
194,5QXf6LTnU8acduTSFxJXHwhYxiwSQMxcNYvAAekzsDAiqjoa8XiWhN2Bgc3A9Sbj4xeuxjJ5Vt8Sfwzy2E13vkyb,true,293305067,293305068,1,1727888778,5226
195,4Z3SWgZVQ5CFYp8hvMTHZj8bJzNxTrGmAwEJJSsjgNL3YR1GZsu5Q6Nj6u2VVxCjocsfevmcn1kCtv2GgDC1djzw,true,293305067,293305068,1,1727888778,5289
192,RZCDhd6PaNSwT4b6WpjxtkBsLQmH8EjthwFE1u9XvEa3tkF6cJpZy21u5sMgK2zKefactUUVd2Cow8QDg8XimZj,true,293305067,293305069,2,1727888778,5196
193,4sciEmiR2dLUouj7TzfRw5amMU4p36nR4hMq5n8cAGUqqE9j8RmoxSfnR3mxkkK9fPyTQtaJ84voBvDYwWu7DVYN,true,293305067,293305068,1,1727888778,5362
197,4SM6gsg77nU4MHgHvmjhUgkmjA1Ni4PRAKFNEBFJqweQw63Ka1sZdDDBjjzgaTfYJKx4G1fDUXJGGUimbF9wagCE,true,293305067,293305068,1,1727888778,5361
198,2G9jeVEHGc9fVxiuGceBgndNpoKHE7WpPcc9EnXtCaYomQ8oMY6tFLJzfBnDKEM2389pa9EcEH2AjUy2C2pbM2CE,true,293305067,293305069,2,1727888778,5225
191,5DUfEYLQMpusMvS6SLSDXvziva3dN6CsQUkqZYQWWRfwHcrFSazZsPMXqZ7o5nLendyL9Su4cbiFHKZpgtuE1JvB,true,293305067,293305068,1,1727888778,5524
200,2BiV5dEFd5XBbxwsEAmd8D52dRhGkMT4DezNVbKRJzyxvqJt4JFAHnbUFnD9jLuNEQEAn5CfqR6kuXjy6amiJ1M9,true,293305086,293305088,2,1727888788,5195
201,4jMoSQody9gS89jvf9pxoX834aDDC3EZWhgbSBEXGJr4nZp5tkazUu49Ab4HjS38cXpFfec5RMNU2Fw6iUnrsBnu,true,293305086,293305088,2,1727888788,5217
203,2zQzv8gbJ6ckk8eCR8rQQ4bPXBmtqmshykk7ekurWfT4HGSwQ61sVkQfmCs6amvBQizNJbvNiMbVkqJo6xsd9pnt,true,293305086,293305088,2,1727888788,5217
204,42bUDZodd1o2MZkA1SVTzngqk2X5uKwqoveSM9JfRpsLSk1G9S9dFoX25z4HzABhrKQLGZ33UG91Q6uRAmnhie2P,true,293305086,293305088,2,1727888788,5279
209,4rs34V8z1ixMM1DuigemgrNKWd5ypM498dKQgQ7f2HtuVFJiQdNnaiLRxi5P4XC1h4g11eLADP14zwZL3n81LzBn,true,293305086,293305088,2,1727888788,5319
208,5itKKmsUVQ8ve2qfumCFwQekoHGdmEAhs6QwDQ37LicbCp52smnSn4Db5pnhEYZeYHEMq7AJKNzDpvoEQbifKTek,true,293305086,293305088,2,1727888788,5205
207,7Q3rSAZyDYMZuZgHfwSNTypTuWQieWjzgGXRqsc5daicAiuB6jvZYoGApvbu3zJBnEhYzEJkPi1EgNAi134tpVe,true,293305086,293305088,2,1727888788,5249
206,2dKPR7xYKJtJyGnF3TnkW58ihRecrDFWVFtLHAWZzw3PgmLmm2PKPS2eUX9upQLR8y8YyqvJYHSXGUxYQvXuchYb,true,293305086,293305088,2,1727888788,5406
202,4aauFGVTa8ggD2TaVs1VfGvMd9eVuLas8EDQur9fL9G7Gj6cGN6Dnzfgp9gixM3FwC1BV4QZcE3rh1Pw32fEzrBe,true,293305086,293305088,2,1727888788,5437
205,43JSm4JXLZDNpWCjzn3U68DjVuSycP9M3xKULXUTvjSbMRUyV6UG9ZWwZ2B2Y6cXLYkj74kW9Vn7kBghFXGywNnL,true,293305086,293305088,2,1727888788,5311
215,2LdedzbeinsYzV9Xhm9oxfurovfJvUvY3SkkYVgAt4UtVPbySbWc82SXM3Q4HynQ1sUvYXGXeXpEKQNQa65TKq3Y,true,293305109,293305114,5,1727888799,5197
217,VZdWmU7Bkixn7kCRoGsrsi96NFfjiHM7hoiRHduvXnifqGKJ3UAUuMLH7iY2FLHgWhSy2F6gcCy7v7ecZtWuMgJ,true,293305109,293305114,5,1727888799,5235
213,G6KzfgX164PhwXjBDbf3Dhkcvf5atzwgeCW1kAYAc7P9B7WjbeA2aUbqDARHZhiUSEhRD9jJ4iG69WgQxSyh45H,true,293305109,293305114,5,1727888799,5218
216,ggixrmssLvkwi4U8CA8auSJbDuzZwTCdQ5TdTfqn3Tgei1sJ9fCQzGrwP6A4PpKFBB17UQkT4i7ppZu5SVutZxL,true,293305109,293305114,5,1727888799,5305
212,2e3YSvViJyFbn3acNqKDQfQbBRMYBDsLYbAGb4zXRY2rUeo9P23j7X3ZcgdgToHX8eBSZQygEZwqKtvo1dETMQXY,true,293305109,293305114,5,1727888799,5344
210,4UqNUDGsdSgXJtvZp8xsNpHQ9wJHeyhLbXsKfjo9DYTRESvThRnvNUvWCGXSEoJAGNahuRimazUhhU8x9WnPNbn8,true,293305110,293305114,4,1727888799,5231
219,5UMh6F9ZiEnuhTcfDKvNjWKi6RuSMRsqMBRHUQVJRKqreGEthQtuYq3MsX3R9HGjNwg7QGQzWLQ5uTcAVjKpBi9y,true,293305110,293305114,4,1727888799,5273
214,2eXYoDfcSi5iGaFetWa3LAEes2YJY8caUVxF4yDF5tsLx16r5we2MphmzbsuH8PAFqrvqCn65b9LqQ4dqHXLoWSh,true,293305110,293305114,4,1727888799,5218
218,5k8TecBSgZFXYvSHi8xHQtvPMJDqEbtKn6eNQvrxtigNF5f4uMAJWpmWc1BkEu3sGRHBKwcRcBDqTc6ioCvwFDSy,true,293305110,293305114,4,1727888799,5412
211,45pwSuzYir1mdsBYS64wzgqB7oE9URfgs7KaAWPMJK8QqtTX8ZDGx5MtWCdbNib3MW5jQ9WGjUJp9PgPMt9oKKEV,true,293305112,293305114,2,1727888800,5206
228,23YuhA5FnZFEzp5YHbdid9uZG6TUTtRyf7SKKvatdzHhjJr5LdmLm9rik2q7bBbuMDK4ErcirmfBF2qNoCuZyqwE,true,293305131,293305132,1,1727888809,5178
225,5frK2T8RSAZV4DL6tcHmh8oDMtsrDCEvAXpuQbYKjtFgoRREt3NyBnMotAQ6CX7a5W4ztsi6BmCc6gaSFDmUPpkC,true,293305131,293305134,3,1727888809,5204
221,2EW3XjXsMbyVXe31PLsFwwhEBZwq5bXmrXCogZ5PKpwZ4x2ZMNTWJbfmz4JUBYAejHpPadhvVMhFTujoEXeURXKj,true,293305131,293305132,1,1727888809,5211
223,5HwBYXKSaAh6xjZqRKdSYpwsg3C71mWhiTGmbnx4ppaij66phm8EPYFyi5GdSJEE1oFXqfffzjR4qsm42FBpVLph,true,293305131,293305132,1,1727888809,5246
220,3MuTz8DgeWLCsu44XSrGRmhQ53vndiHgvg9S1KMZ57EY6WGc1Fx4SfD2my5EnJF3w72iL9hDxJz897XMWGXfobb1,true,293305131,293305135,4,1727888809,5264
227,2ZPRnYiLbkAeXm8NCg23YuCACqw8xMfvFwFSwwvQ5mWj6ckncNjXgiQofmYwsBfBU7kbdcACWDVzj6SJcU4VjT9Y,true,293305131,293305132,1,1727888809,5279
229,4X9JVFjPFDSXcjwQWyQeS7hpTbmEQpFQbqBfXdpXWpZaaAnv16WbFsP5JLH3tKiNoJeaCnJkTraWdSsKBuqpXVBr,true,293305131,293305132,1,1727888809,5288
226,uUHpdUCzoudJE4DQPf4SKegBKM8GKADvvQYPpU9AN3cPbpvmbaHYnftkhpRMCZkDYfTgVUuGMeGtRB84hprickA,true,293305131,293305132,1,1727888809,5282
224,4X6Yk2NpLte23giYZbuGd5fgMPmYx8qhprDi9Tm7nYWmEJEUGejigXHuQZXkWmf1XvdM9VCjLek3xTm6hRbQAwBT,true,293305131,293305132,1,1727888809,5400
222,4weDCyzc6ZG16GN54tAB7MxQ1crCTejxJ74HNQfbpwXPZYKHEigDyQQ58Y75AGHV8goUsgs2qguTrV6Sv3nfUdnG,true,293305131,293305135,4,1727888809,5216
238,61Gs3fDxQRMfFsopbNqGjxHopmW3YEk47Z3ZLaqLpp49nyVhEccJHCQPcncKBhjZRGU397AqXUYkLyqXCmog8L3T,true,293305155,293305161,6,1727888820,5205
230,3BqqwveZHahNq8m54saRSG4tey7hxfjvDCNfmMhEM16CQB1FqTkagztbPdVuFKg8mfJcGcWnBY1aBn7Kxf5SQreM,true,293305155,293305161,6,1727888820,5215
234,jC6Mqv6QsLuq1KovJpXSbE1GehYvzGhQrHu4Su7PYp9REKWiVRyr59S2CDNqhPLpq353JPdaCgPjELhGrjsjJNz,true,293305155,293305161,6,1727888820,5195
239,4nKD6CnvRFGTvBy4eadRTdPDSzPzD91vCZn9czMW72ofGgCHkBWaTWCZRSopUSYKKU5mYP2oYkd4d3jLyXt29xRr,true,293305155,293305161,6,1727888820,5197
233,5uyKiAkhKm4m9N6qXnnFzSzSzX8HcyV1GPj11LSBpKGHziU5SLE7fFkVs2Y6zKA6H8JsNJdF7jD4Z9fGG1fLxNmG,true,293305155,293305162,7,1727888820,5336
236,1LihAmmSSBRyDsZK5zZFAtRPb2yFDXdBwFLeE7Bykqf4rrJQfnmTdX5fGMJaY8qoz18YNnwhkiNABtrGByN1wAW,true,293305155,293305160,5,1727888820,5328
231,3yPpAnaHiUGnFADrtUAQauCB3g4gYepNc2AUPvwx1W9oQpHQw3rGmbrku8DNkhM5jc5TAgqDjeEnK1Fs5d5CbXKv,true,293305156,293305163,7,1727888820,5279
232,271RoCfwiakrCxMpxqAgT99SCp7zG1XdHkGPtCSjZvjkchLQCfnipiw3b53JhhHw7BRMJFp93UobehdGE6tJ4VDr,true,293305159,293305164,5,1727888821,5194
237,4Zvsuy5yQPuJPb5zHvd23rnHPeKifr7CwtpyRkPJnpD4V3zdwA4wN8uPMBRVpzsPo4b515ydFXRJB8iaBTQnp9XU,true,293305159,293305162,3,1727888821,5185
235,33ptxy7iKoR2w3NHoKJ7EtmuBg9NfY8XXXrx6DGaZQBh2x4QfeKeoYQMKBXj6iqjRcUQd2wdzyuKudy5tc5nioRn,true,293305159,293305163,4,1727888821,5272
241,3bmpBSwRuLduBhdcQNkZ61TdWPC7ScBnLgz3Sh2BpAHfGk1nJXH51D2z5jf7i5gstMu55U6zeWv7wo7DQdG6pv1A,true,293305179,293305181,2,1727888830,5211
248,KHydtfxCphSttwy2uaqm7WLbXFYJbtrCxmm7Wb8Yr2LeGCqvZX7tSU8UAo5dt5b4gvHyQyqRq9nY74cA5fSkkoB,true,293305179,293305181,2,1727888830,5224
243,4hdxMc5KFYZSVjafYyZQH2DsUXkKd2SW2DaZ5zycRVdZEkQx1BNGGgL9CBGspdDtLZgnHu7he7kR4gkhjcQsQrBF,true,293305179,293305181,2,1727888831,5155
247,vXUbDcP8kE48nuoM95hNAGTE3qZy4jsaK94zUirzsv4RUPXUJUHe9gz5UfJPxjSdWN9M6wAKk8JFhusePQfbKZi,true,293305179,293305181,2,1727888831,5208
244,2WUP46GgXyrYKQi7C1cH3n899v1FZV2d2k5tTicHycVjU36w1oJHEq9dEr5R7taGhcoK1XXK5fa4GpUhDdedLkot,true,293305179,293305181,2,1727888830,5310
240,3apT112FJGxrRdXMmgTxyMwhZjGq39b16ohFF3JZ2D8m3XcE1JMTLtqUKg4MViGW5RryWSgyUhorxBy6UFNv2eUe,true,293305179,293305181,2,1727888831,5176
249,48D2HvKmEEZDLzaEQgcy95mU795NJyuGRiYHWCvF9n9B6Sj87RAxgsonu3HbhZB5tUPPaL5Snmn6dUjhJsQw9EQ5,true,293305179,293305181,2,1727888831,5293
246,4h1zrBF7o35BNyELdZ5mPrb2q4pYadaLhcBMQ9c6u4BvMbMt46GBPuNamZ3ZXdBGxrqFpGjo9uq6roTnKxWinuYs,true,293305179,293305181,2,1727888831,5183
245,3gsosuKymCJC5tqfZ23McYzpETPPmwaW33Lh63k27ao6znDDA29381Ue2VdiyzbJrEnpda96qKFwL5NSYWTKXjL9,true,293305179,293305181,2,1727888830,5340
242,3ph8JHfsqswbv2YTuxjBRXAWfEt4M5JSwsP6SAKSZtEFgvdAejshv7gAVVwnWbb2n5Fzon8nRrTa4Cw31u7hY3WG,true,293305179,293305181,2,1727888831,5354
252,3KsVWk1h1KC3JcatdbZmCNmCMaSof1BarhsCJ3yWhhtL8UWdYEua3yibQVh74fhnkeb3MHjy7u5baXAZtPhhJRC7,true,293305199,293305201,2,1727888841,5200
257,3KtgjHPiaXqQGhTiBdhvTwAY86B3kedtGWL8x4LWM6Chj7q485GcVxKcNedSPguWBCXHBVrKHQeKg3EYqVZioaje,true,293305199,293305201,2,1727888841,5220
258,5LhoiMrgzprSqHehCXMinLap4wJXjnzG1nfWGjUpFvChav1mUvKSoHx2Bh9uX8C2tfnA7sQrezYKm1zHfNu8ckwJ,true,293305199,293305201,2,1727888841,5227
259,vcg5g6faJkJmpZXQiyAiWtcVXbHYK2q5KEdfTWvkqv9u4TUBr7dSpzmnaeeGyhd4FGFAYnkqULoiwQfL9qfUJCE,true,293305199,293305201,2,1727888841,5191
251,4kVzMBnV2V1A58X6dp4g2NZuudHburfvqKTFaCtdudCbTc8S5kX6bBbPJhNFXHaS561pugQ8xnb6wWN2JJ6tWsZm,true,293305199,293305201,2,1727888841,5183
255,3cAafbyUZBhHggxDckxA5mfaqBsTdzYYmmifKJESgGfaB4d7r9mtKDH42r996ubyGm3Z34SRVma85ZS2wfygMjTe,true,293305199,293305201,2,1727888841,5188
250,3LV3HpYwYaVkpsi9NT9qq9NDTErvi2Sgwvb3G4GHhFUNmcmscijiTKJh1nMtYvDcQ8dt21B5PB3D9rMq4obkdq4C,true,293305199,293305201,2,1727888841,5193
253,5JQf9Ddn9e7XP2uHAvzaVETo2UR61R93cjepJW1NrLrgj2wTkf3e3eWdRxTpAuzpjRrxyiW7HzN7dMkXVJZWX6aN,true,293305199,293305201,2,1727888841,5309
254,2HCYKNokfEsNypxd1M9EZVHoKCrULcBR5aEGmfihHHKECwxP4jD68kVvoKXwSdapbSPYQkQYWfvLNf3EX2jwDb7b,true,293305199,293305201,2,1727888841,5176
256,2nNXFHLv7EFsVU3HgNdWSp2yrrCdF4a5UNGUfi7uKhSBEQgBqnKSr5ejH9JQDvGJPVXAoYR5YBfqQBJUxaPu5uQf,true,293305199,293305201,2,1727888841,5396
262,3eJpzAZrRzas6mQAqekuverEbSTHLy5ucZSU57kiLjt9K7CUazXKVonKGPEynfmspeD2HnmecfQ2irBgUwtLFSdX,true,293305223,293305226,3,1727888851,5179
269,5j4NxT2MnanPjrsCzkn3J6n3BhbsUEYb9jyA9GscK8TFhweKZ7yPMgvr2Tp6HiaeoAvLBzby4wogv34EHRxocZDV,true,293305223,293305224,1,1727888851,5209
264,3hBorsERxmyqFfx3hQ7JSdYwoFZ6fmWVzzGgPwTS6JJcQtaNPxPbPUdTwjDkjHL7p6k5iB6NrWJXwVs1YbWZLz9Z,true,293305223,293305225,2,1727888851,5212
267,5FUebiSW9xjn8PSnRjijnuC48RjZm525bwV97QPdqPxxvZpxn8PJr1mQKafjYtq1b5dDHvsmVLAugueU1rRYNYhg,true,293305223,293305224,1,1727888851,5283
265,3kXVFzHov1poDuBTbCZcvRiTSmgYrrHTkm2vsa4qM36oKKNDoXrybS8cuVYrRNMYeUKXcUw7RzamzUfT3VPGyRQ9,true,293305223,293305227,4,1727888852,5194
263,2tQotvCDqA8bdTh9Rym55XKkavSSmQdyUZuDqfaHv5MK7DTwLJSQgvh8Gs9YutPYjd4MYWWa7CD1C3K4unrz2z2r,true,293305223,293305228,5,1727888852,5173
260,4okjphVMHjKjjbpiGVaJLkNjprKnoysYXRKZPFomSkzoAKcSTnrjyRkEft7bSqidwigr8efsuu2BbRxgNaqWGDVT,true,293305223,293305227,4,1727888852,5276
261,2bqsFcMKZyHs8q3FcUCWxok2njFLoirbVfYmQbwcvixZkBTfGYijpkKkRqATAVPqCzQqtyFi1SKFbP1rDPN8iqbV,true,293305223,293305225,2,1727888851,5375
268,2sPJ1Av1aRvgnkNnc2rAy93aq8t1RLbASdmxHCA1KjX8bKB1UgMbq7ZpttJmPeGY7eiz1nxCtW8febrLED9AvySd,true,293305223,293305227,4,1727888852,5366
266,3Zg3tPTVaUaFkkx22gifkh1wA9u3NrahpabAGwbdnQDBAUs3JcC3gmWCwjEkj5agoSi2Namj7L44ceJb1aGsuJfc,true,293305226,293305228,2,1727888853,5206
270,3xbPQpqdGi8u1rcGsD5vUhNy1qiRJRojCtPcZ3jc5D3p1qsw9LEpDMdiNxFhZ6K7mcKDnGTCRnmVrixx2NvEeauW,true,293305244,293305248,4,1727888862,5175
277,GN9WoyEcpspCbq5p6h3gQJ6LdeaNGFjYiYNDDvwsJUEnYYYGv8j7exMtytAZr7DLmLqBVQccCRksfYNeH1tDabc,true,293305245,293305248,3,1727888862,5202
275,3hpa3armvYqkxtXYgv4j6z8mCQoDAFkxe74iN3phS5HmmgSWoJz7erJ5aQL8CRraNqzE3KGKKQXV5yWsywUPan91,true,293305245,293305248,3,1727888862,5195
273,3bqeMCD1v8dUwJwqYef3BaAiYUgzbiMx9Sa7pU5HBCwdHv4xQTisfuSAJPuobjkJFncyGSZkRb4EffUXFVojbUC9,true,293305245,293305248,3,1727888862,5194
274,55NNPaEUXiG7VKrAVNStYPq5Dx81LpP9nnfqjbocHxwCA272eKsi9ufcGPuhnmAU5dpu71ZnTFaDux9JKCXd5pJk,true,293305245,293305248,3,1727888862,5224
272,42kWpPiW7D3yStVNsZqFaSenN7z7wiLiLBqq9DwvqYLZ2DkmAYoUPqvWFwRbUFMh21x27g5FivHycQe9PD1YQ45t,true,293305244,293305248,4,1727888862,5289
278,34y8s7Mr91dSUU16yWM4dit531Hwq2RFk9YMcDePiebchrYGgFpDfzAiMg65JqqV4Tdyh1pE8xifhpMxwPBm7r42,true,293305245,293305248,3,1727888862,5290
276,3U1A2DRLrrcf8E9Zr27uYyBNf5dsmmWXqSHxNPiPjrgqfeByuShzM8ezomLN7UDytXcuSWd7iP7LFNUaRwQH6aD9,true,293305245,293305248,3,1727888862,5302
271,36RS2UTesqtVi8W8syy3XSpZqwoJ23HgJKyp9FtUg4LgnUELX8JLrdB1yrRAdriasdLdXgu8PcA6KpYRUnFwaub3,true,293305245,293305248,3,1727888862,5428
279,4SbK1j53xqd42H7dedyznkok1gJrD1ykERGh8eoTqTRdcdXhMyTmLyXxfCVTbhc54MKdjSpZvC113nrSJhgGh4Vt,true,293305248,293305250,2,1727888863,5313
288,Failed,false,6969,6969,6969,6969,6969
289,Failed,false,6969,6969,6969,6969,6969
280,3jkfC7KE7hRjXij52saKAywfR7EKk42LK1VwfDRk4Vk5jG7Qe7NXTZsoNVmWESQEexCD56k4a9W94udnQ5FDMR3R,true,293305269,293305272,3,1727888872,5193
283,3hGnepKdad3Nf1VwP8jGV7RYeN23s3TS7C1Vny85cag1uPevgjUiHDjzs1vi9Homf6S9RMWN8qtj4aX2Q1uAn7jQ,true,293305269,293305272,3,1727888872,5198
281,5oDanjt9HWebVPt8R7V6Y3KRcskHX8a8cH1q6SBFQ1zY7o1jKa1n7pmYSY7dDNYZou3J4fDxoJbJTsSRGs1GQGQn,true,293305269,293305272,3,1727888872,5166
286,5e9erwEod3Ajub5HRK5jMv2DkWLi6hri4GH2CNZWaRF7aX22sfz1QrnhT91S7so5PibzZiADror1gjuncjcTcLwm,true,293305269,293305272,3,1727888872,5296
282,2Hn16vppECvE6jshvTror7e1BLEAdNz53pmk8Qmk1UP54G6xf6kpvzEpnykQhefJkpfqfgkWL2HA52VWcP59UvBY,true,293305269,293305272,3,1727888872,5306
285,TGaAJAnNo69tLHmCneCbaA4x8D7nKhAiQhQfGKSf9YkubAqkfB12E3nYqPmkxeXHuEneeeqRCLRo6qH67kArZVQ,true,293305269,293305272,3,1727888872,5285
284,dm5oH2xgdgQMFsgSuWUSNUUaCYwA3MMmLZVpjkcKjG7zX3mrzJEXRm9UpAYsQ7bvJFwhyMSm5AUuhHorpBGvExD,true,293305269,293305272,3,1727888872,5513
287,56t49S54A76HJbHUc8S8icVfAn76RWiTbcJpVGpb2pvM9wbtRBBFR1ojPJgJgiH851yFqggocc14WGw68FR2Mbcc,true,293305272,293305274,2,1727888873,5249
291,5XYuCpL53QxrRPP9fAd6eyKR8u69YcERDgDVHnqKQvcvyaPnjr1vwEc6VXSiri3QbtqfV2C6cxknQMkHcYedszaa,true,293305292,293305296,4,1727888882,5200
290,vbmGTynLW87vLRgGwxhCANHxAj3gBSQQXwEqSnPaN7wZ3NGq9o6ZmVMvNWFgQGoAvai58zXHft6sTmDQ6fRLAu5,true,293305292,293305296,4,1727888882,5223
299,5LfHTdGBAc49ejK93Em6VE2TfGNZivE73V46npUR4aksemBJUMuqd9umrk6s2GPuzzz96QTS6ApsJN7aUD8VbCCH,true,293305292,293305296,4,1727888882,5202
298,2CPTVEgaz88pRcAhW8Vv4U5KnFZrrt34ggKqCBDNXRAbKpc4rrfqFy8FPxqaDYQRyvdnas9GSgw81rtS36B9g3MX,true,293305292,293305296,4,1727888882,5222
297,onkfvGEkeEtwWQXqoM9kF21AnyEDM2Dj8QYPwkQKQqoWawmKdiT7YRpDrf3NG6SqaRtrHt3ACCtWqs46p8gAL4u,true,293305292,293305296,4,1727888882,5295
294,46LFeFUt4LpYFZRK8Z6iyCbYoZQS4XhS9nSYyrUDpxPXDTN9oLLouxdGV2psKYHXSXMTXNPatikRFbeaNxxMcQsc,true,293305292,293305296,4,1727888882,5327
292,4e4PxhCSZetN3AdEQJmHwNospQPndJSLZwZuYkA9sCeuKnbYZWWHpnSpgw2sWhHEycTNDevwebNuGLuYPqkqmzZ2,true,293305292,293305296,4,1727888882,5337
296,65nSoZNEv24rnTbStAYdGWpAg9RQjVRfUdtkDiNxp9DDyAWUyqYqeeVNAyWnoRCQBErJ5f9bsuZSYMNV2NMuVhVw,true,293305292,293305296,4,1727888883,5183
295,2QbBiZDYoqwpP27q67iVAmS2zTB9vhHN2zxtWftXj9rTwKWXYK21kDDeSzvcCz9XMxEuUrQuYHtTEHC1pBEFnLBF,true,293305292,293305296,4,1727888883,5361
293,5odS4WVcYeaSzsCm9g19BHxWZEuUZAZqZeGZsSAbRvA3maxcj3H46p9MwNep9RZjnjkkGyfe2ekX2wzRBKhWfXa,true,293305292,293305296,4,1727888883,5291
303,5UEMTWZna4MJhV9izhFqr72a6eKiaow8bT7t6XRNSZHumySLTyQxhxrgWqEfbAATToSQSZSsB2GqrrSWEypEfoz7,true,293305315,293305320,5,1727888893,5321
302,2zS7ZFzG3EVDMRTcxr54T3JLRACTQAL89yKJ1tdjBNGVSd7hGpqpBAuvUTPLCZq29SpLXwfNPBRk4ev5KBsCdAji,true,293305315,293305320,5,1727888893,5227
307,4T2RuDmQpy395uvkZ5JBCHHVNKBU6n5zzS6cVYz438SywADrM23RhbVojmky39mZGVHmnTfhBps5pDtHqtafGKnt,true,293305315,293305320,5,1727888893,5311
308,36Rv57KkyartVgy3C2SdGhc2N8xoebsY6SZJuoidcvcLQXJxRnqBNtRZRNopbFvdPtiP8QhJbfp1b2JxDCe9nKTs,true,293305315,293305320,5,1727888893,5376
304,MkdFq19CsLzzZ6yDwyYhpaBvmTn52ujQg4Y9wzLi3z7msqq7trR5gMxzp2RWCJXcZ9CPmmkxfdarDRTWRQjMWQc,true,293305315,293305320,5,1727888893,5370
300,3nWqociHcg3iE1ZSh8MKehWfKCMoDfcepLiyAVrieeEAH87vk6xsBKH3BT7uenBZfwjh5J8QvAjTC1Ns9mz6Diwr,true,293305315,293305320,5,1727888893,5381
301,2Rib4VvCGLnrY9mUfqB2bEFyYN1mqFEpp4SNYhxnJUwjGY5fsNQxaucxh8RsdYbbMfs3hKsSbsAqycU4PQmbkVcN,true,293305315,293305320,5,1727888893,5384
306,SXqnB5dTCn6q96RJdfvTYx177ADh6tSudGqZKMToQduASkxcXTGECfZ1U2xsfLi4vmyuViNPxo8Y94okPDyC63c,true,293305315,293305320,5,1727888893,5400
305,5sGhCL47vj2qQ2p1KA9VLELZwF1hcWv87NezCCnmFMwLxRopK4dGCGgkM3V6DtnsrsHUmKWSsbPfvLzfvT9N8jCw,true,293305315,293305320,5,1727888893,5334
309,2W1oSSURYVu2QbfpU3CzhGy3rvfZi71eVTpK1T2MLnMPtrqpZ8qT7unHWWCJw9Yw2a2F4vkVSPAGUVBod7kmDL2h,true,293305315,293305320,5,1727888893,5529
316,cW9ydYo9zG9gduUeLDLoiSS2Y96qMwRd5RMKm5fD9DfF6jua9YXKbuZetFa8znfhygcVzdw92NQHmDBnp8E2WLN,true,293305336,293305341,5,1727888904,5644
317,4wXWgA1fpm7XApnA6h4MStwXvMdtpqNNmynGbd4tSKtSTKSUou5CHSp7GbkUDGHsiKdRjBhBmpEdKz1ThDb8A19c,true,293305337,293305340,3,1727888904,5499
314,3rKqspFoGQDxWVQ6jb22meeFZUrPdAQrcHfAmWrKQQ7zfa4YrLcxRL4LfRpccoesz5M4nsD1QYZmpL5jyLnBo3cX,true,293305337,293305342,5,1727888904,5609
312,3QJgmvM9YqBX5AXcmse7MXRQDMDuTcK7n7FAPhtTHDYNt9rRkbpo6WQyuVRcAhPHc7mATKDyNwoUFd78GhaAZXU3,true,293305337,293305340,3,1727888904,5611
311,2v6PkcQWTW3RJ9r2cTXHp6je81vd6HKeM1FuScsqEsrMEnLmxcD3xe2LGpXTrLBCKW9Vk6eE4NpGAPhZmLxCpM19,true,293305337,293305340,3,1727888904,5581
310,SZsZVggSbZGmuJhBemkkHyFABn1o8w38bPd6ra16Hh6uBMbCHmKDjjLvNgCfyRmpNVJStNC29TrmccWdSpa5Uz9,true,293305337,293305340,3,1727888904,5729
313,5LwRB8rvc357XAQdeQFoxEC9CTLN7Jne6i33KA8GJ4DshtxQmesyCoiZAHXxf5PwhhUwxHvXYxwXBzi8QLXGS3uc,true,293305337,293305340,3,1727888904,5813
319,2Q8cp8qVyYSFqrPuTkNZYgDkk8icccUXZdQfK4QTAvgsyA9X1YY8PGZUQmsg72hTyMB5Nshu7y4DCx3SsR3Lq6Zh,true,293305337,293305344,7,1727888904,6835
318,35Ce6tGB3iZiuzXSZ9CtZEGJD6f3meXtRedchyn1sLjB9NHb84vFwg3NAYZTK8Zyj4dfP9UC2R8yLFCjEXAQJgDb,true,293305337,293305342,5,1727888904,7701
315,3hpkdZGcQfAsriKdSefihfc9aiz296RUf1S12xHVXGwwy9FTU92EJV8XS5KYypSXZvtPKz6nQ3QyjgQYZKM2zkmD,true,293305337,293305341,4,1727888904,11636
321,3t8VyTadtn5SWQ24QWeBUdJDGJ8sbKD2ppX6ZCdNEDNCGnCizKEAi9VGLCXS8Aj9oz1NUG2ELzkMmLMrMinXXQXE,true,293305360,293305364,4,1727888914,5300
322,26P8s9K6QwrTUk1nHmgU1kgt5UEah4ronfvvzsPYyDX3ac4DpNCpwnbYEtNaakwG59Yr9JozTDEgGJTDLRwELPNn,true,293305360,293305364,4,1727888914,5451
329,3JLmT2ckaddj6AVMxKXj327H7GuHxSQnea8R2hffqfuDByKbnvhg3yHnobooYHRJ58gcnXv9doG7cifDLvkJzT4L,true,293305359,293305360,1,1727888914,6155
323,4N8PTgg9pBqUagTNfwTZ3JfFbthJJ9Jo5148wmFiqGyuqF434USzV24EU8Wymai25cUJ4prvpRcHsvsz2L8Z2uE4,true,293305360,293305364,4,1727888914,5796
327,gpQEZExy8T3TfWYNDmzRJbQdt3udibtaS3V2brm7LFBdr8WsteLbLa3ezzXaBQcyMxqkWxPqThAQKW5L7DHGxir,true,293305360,293305364,4,1727888914,5650
320,5eqDZZ3uuCHabm1GTKcH3DfciPDmLgipEXcKo6r4mfkkd3TTN4Wy3m5hdcHgPN6EESnymFBCY23AGujcUeaqDLYP,true,293305360,293305364,4,1727888914,6119
326,5nXhgKNbddnSXhUMhqm5AwuZbHdFdnvRoWiTuDrFjxF16B82pG3WU3vJdCK2zZq4gfLjDFGDNmZXWFvrEMtNXRFa,true,293305359,293305364,5,1727888914,6250
325,3V2RGBhsR5VBAodyUha3x2uVtCid6A2VHTC3tF6aiZWnK9YT8Hza9f8UKUSLK3QvzuqE94sbfzyCGJvcDDsTNH8G,true,293305360,293305364,4,1727888914,6154
328,AhsT15XxpeCPhhvv1pXxFp9UpFukaPLdwJZwsbAeWk9tjW2c1XJhs3GC2kvmR9N6T6bMxhAPUUaxbmTj7h38XKC,true,293305360,293305364,4,1727888914,8166
324,ANswDXbNVR5rcjHLM4uVKqp5rESR2x2UGJkka3ZFyWxieisHiYVPX9yuQKtooG57VoeZv1B65QMZvy52sJoEHhv,true,293305359,293305364,5,1727888914,9269
334,52YmEbHM2HRbuxX1QMTVsK4HjvtTNBLvzpGmZayVPE8vSMmSciXuxAKseZ4YKV5fYEuG8JHuU3T15ArvsDH58y4e,true,293305384,293305389,5,1727888926,5392
339,4KhPcTBWGuvCW2YyNN5x2oqaqBZhWvU8dVaCNacaad8qEsviExW1Sxr6fzgGgQxcJdMvVHpdaQ61ogccS7ZBv8Ev,true,293305385,293305388,3,1727888926,5583
338,524cPefmEKD4YgdDDxPDz7CH2N1EKgEnWML9hyujvqphL8y4j9XwKEeMefd2D6uDLMtShVBvC2m4bQjynsL9cqsc,true,293305386,293305389,3,1727888927,5404
335,614e7frAESjzX8VuSCsdj7BTZADThPq1oR3b393rR9hNpvyydqgZ6wm9zkTFSnZoGxatAyWf74fCGU4ah5rswqYD,true,293305385,293305388,3,1727888927,5647
333,4YFTE1XSexsjaSmYtcdqzUmzNgDiYCqCbxs6X9zaeNhNBN1osUk8EPQriwwS2hAmqN9uzprFrJXjYWWmirKrCgD9,true,293305384,293305391,7,1727888926,6124
337,5yRDv5gQY44aV91H8xSL7Jw6RNU8oetVdkaZKLWUzhGX9FELD3HrEXmAmVKvReKDYZBVzZv1NsfhoueoeQUB7UaJ,true,293305385,293305389,4,1727888927,5650
330,5mzAWdTmTbSYLUzYEMEDnGs51McXrnQTbkMmePdBzgdf3AxsYqbiPLA8J5TPuVYVBQCVr4GiguXQSwEoctWh2Drx,true,293305385,293305389,4,1727888927,5677
331,22xhcWkqLWiWztRrHkR62PHTho1swmJrZpmX9x4m7U7Tj4iXNq2nmJgv8UWKYkTJ97fjjCsKWeqHj1y7qCTDiAf4,true,293305385,293305389,4,1727888927,5729
336,bVcSZwd3qetUei7uRf2HWdfTMZUHz2tQqyMyjLJxxnBjwZ5Tko5KV71uX7Kn41LxJiLVX75CbLo7K37szsasHBh,true,293305385,293305388,3,1727888926,6064
332,5ujfhBZoopMDvaNBSrCSstxYevyvNWxf7Yk7VY5hZ8Bat4qmmXzW7BwDVFPZpLuqgPAvMsHWoViMr8hY9Wj7ECGu,true,293305385,293305388,3,1727888926,6040
344,5e6pnqcsGiouifn3cH2zPcucJdCRW9iF3PKB2eWrQuQuBtSoiuQUHGe4vSX59sBXCDsRtJ8Saud4or2s9pXdL8ZE,true,293305409,293305412,3,1727888938,5560
341,3tbqqyRx4HKMpQwdfQqmYwMR3qXVMCmSWMpWsbsgBUdo44VxUhM7Q6SCZUCRqKWsg7utF6KTUjw2bgrUqBpxUxDL,true,293305410,293305412,2,1727888938,5173
348,3MmZkyDAYviXX3A2ZzqmvyQG8cQqC9CPbT9xJUYCaRPe7RYLjr4Fd77HRLRZtgMapE7ux478j4qtDWZmc4HhdtRJ,true,293305410,293305412,2,1727888938,5517
347,34oHGuDsbZGd9WhcjkUs46mYo8mcz4fAaUMC5oHWjtVHrkUKdkuoVGtnsnu7aZwntd2CQkxqiZ2U3KzuUmWiBAJo,true,293305410,293305412,2,1727888938,5529
342,5vhjcvcR8mZfVXzr9UtutdbDoB1WjfUjfKHp5FzAVuVNavXWPLD5H4SFKpNxUWa1M9WnKdffFowHYToDcLuZkyjg,true,293305410,293305412,2,1727888938,5689
340,2eH1iFJ4QnaUFo5WnP1aXeQdosJqCXiW19W6JZLdd5FtT2FSWvqfcikRCZA5sGdiv5kkiEBrVDuYwQboQrSTs2K4,true,293305411,293305412,1,1727888938,5603
349,FG5Qr6pfpr3aAfuSmL39PgMM2mKi6sbkFzpz3o7yrmzxSfdccuweahpGXvHeXZfnJjgXWHuguMcKMgcbxT91zRD,true,293305411,293305412,1,1727888938,5963
345,5RJh86n79qwHRUp74jpPp87ueYixEG92bFXtybggHmDrw9zAjmJ6wDFfnhQ4xyTpPLRErhySa5w59H5TLYGw2a6V,true,293305412,293305412,0,1727888939,5575
346,39Aa9bytHddz9eqCn8bPR9Ljx7fJArCDew1Gimd6ww5txzTXXBeeBYNQg8ybjbM7mQHRiYaUKd5fZ3UYe4Rv6Bru,true,293305410,293305412,2,1727888938,7061
343,3WXkMsNoxbFHeT4RVLFTvfHTvvtB6VLR7SabMvRqMyKGZ7fc7HiVPAxKc1RFPyQoYbr42KrcuW6KMLjfvptNiob8,true,293305413,293305420,7,1727888939,6120
357,3rVzaZoQDTDyHwDCvdfkJ3vuJerMTV2vyjbrsgLVfTtnx1CzVcMXEHeS9AYP2zCx9xqt6WBTZDhvidFn2WjofBSX,true,293305433,293305436,3,1727888948,5377
356,53yeTfTRdUKCBHtQMcJCTnGF8mMuxEmh9azfKkYnfBaZJNuvujZEsL1aRJdJYj5HuAmfe6KmS4tiFgwFBfmJEFTM,true,293305434,293305437,3,1727888949,5307
355,3cyNyFohAqfTe7F7AGqyNbGCEgEtbzWb7pU3tK9biDbNxGA66Dzo7pvtdURXuc4SR8TqNgXi7jmhgaWBdrhZMtsn,true,293305433,293305440,7,1727888949,5504
354,4XcYjb7yUsLf3g66o2rVHQMKoxoea8SvgEtNeyBFVW9XvJMmLmtC4rEnXYWxSdxbKVQg1wSt2jyPXuTbei6Xy2VF,true,293305434,293305437,3,1727888949,5497
358,5kziaGxZUkP6ibQX7PK5Rb5VN5nsXsYUjBjtZMZPUsKNRqJReFtoXBqkFfX6YX7faRig14ayUs6JwfN41Epr1CWt,true,293305433,293305437,4,1727888949,5657
352,4tRBqZAktwhhuRaoqCZ1pZT3p2VEpYngd1VYphjy4y8D1sRcQMssMrmwbzUfkC242qh3xcwJWztLiipbNHCuP1c9,true,293305434,293305437,3,1727888949,5642
359,cac63hYQeZU9rXrP1JUTduK7oLrBtP6PEggjtYzDAFrJf87udfggFYuo6fHt5nsXPXpbiMcA5wDParbff4jg2X6,true,293305434,293305438,4,1727888949,5595
353,5VgumxhFbXTPntYVhpnNYVTLxLZ3GmB76QbLM6ZM7BEvwALHPgDsmFr9KNhrTaYbuqRR1yPZ2pGXkihXQpqXwY5x,true,293305434,293305437,3,1727888949,5698
351,3bNPn9mBFzPJu8kp94EJkGyy3Dn6xKby2YrFyrLmzP41SWxM566SKKnVTsGXzNA76DfV3VYB2PX4ZMrQNomBSXWs,true,293305433,293305436,3,1727888949,5894
350,uEuZFuUbDqkvtPy7pf23JTKkXtG16gdoemRe1hcj3Bt46bKrvUpGi96yyzZPAejbgFjaeu3vxtH4gUgBxcvnoos,true,293305434,293305440,6,1727888949,6227
367,3iUU42jEVek3qi8yxnBQ52aDNTNf2cj4EXuVBbSMrbZgukq7hD448JqaqmpwZpsmgmRQ96o9DG1wxJxyfYJ4wWkz,true,293305459,293305462,3,1727888960,5436
361,3ivYiWKG5AafzjShF9GE8HtihVfc75ioZ3FM7R9x6gzdZ6UX2EnXUUCytEGoyAUwo67B45FfrSWzdoRU6WQ2Y15S,true,293305459,293305463,4,1727888960,5443
362,3pT8nxVmBM9QQnfiuDMZUpd3JStta4AeLMQGJACA4ceBDMrMEAxisYnuht6Cjv3ynp1BxbpUG2Amak46bf8npt8x,true,293305459,293305464,5,1727888960,5616
360,k7spNHboFkSdYMELBWRa2zaEpJ6yB586bRQ63cb6bpTVQo7fSnpWNN6saTb2a5PYsemthnr6KWoB9gj81mEP8kB,true,293305459,293305463,4,1727888960,5627
363,3q59Ts9nBX92hFvZTY463hn9RyYiSjC7Y21SLwWUksLVPYicecH6DJUkHEYrJMGPbKkEgF1kainZc7cxvueycv5U,true,293305460,293305463,3,1727888960,5623
369,vhrgPfTZdQoMJeXt2CXtwJ4Q2vFfn954SoT1awTQfrdVMrC6oyo9yTDJtS8qAXWgTi4KGip6sn6wcwgYQJLjCHv,true,293305460,293305464,4,1727888960,5630
368,5JUAsJHea6ERDBobgHzXDBGFtYUHjczdk7z7JoKz2uc4sCGvd637QLQNwVmf2WFrmXE4krwy5i6oDfdydbXdgsQo,true,293305460,293305463,3,1727888960,5626
366,2iKiaynVe78yyzEC2b8eyX8ngu4F3K8EFQa4G5UpgCFkziNVCWshrTXMDPcDjhWMhbtU7WefgeKGyv5agmxrDrZG,true,293305460,293305463,3,1727888960,6296
364,41S2sEL31HdHYrFd7uzVBzDHZQ2xijS3D4dAXooT9PGNqLHbriXSsMgwgZm1oBSFBxWry3QM54tneanRgMXtgg5W,true,293305463,293305464,1,1727888962,6155
365,skWMwtuWj7QVER3Cts8dgFb32zUuL322MJtT7M1ehfCj5jEhBM4yqeRXmQk8HJxAR8bsAweR9VoJvm1o37bMd7S,true,293305460,293305463,3,1727888960,9194
378,mWBENxiDPipkvEvM3f57PNrv5a6UkGdb2mG9G3ovfYdMQo5tiSYaGwdxzchp3pLBasbj2pMTnTxM8thk9BMJBm1,true,293305483,293305484,1,1727888971,5442
372,2ZzAHJGbxNg2F5EbNwZE4wwsGnzLWNebBr6sJpFFuy4dZt6Zx2mRyUKFwxRU9CCffe2qEmoWLgMABR8Gc4jbZnTh,true,293305483,293305484,1,1727888971,5440
379,64ij3mSRAYfFJMzwbb6eSCKdcJjZtaRWKeCauSuieckbHQhcWDJbdZ49KEbePLEeZbxQ5ddZbyR5TpR7Tctg7jAV,true,293305483,293305484,1,1727888971,5510
371,2hou3nNAkW4FcmAF7rndXm2ugkNZoJYFVyoSv75GuPG9AeGiUd1gqzkbHhwXV6vLqsyoEwvL55B71tA9X4WqtHqC,true,293305483,293305484,1,1727888971,5375
375,3hHGixSAPrtpzH4Lrce4imf7QcW55cHzDZQ7FjyKWy558R5X929NkthYhuNWKVQx3gYpbSUh6Vm2kwanJWHkEVGu,true,293305483,293305484,1,1727888971,5420
376,52tMp5iGxMSTn4P4uZPvm6LFkDL7UKBzVHqbXPK4t6rhcfP2YQ77EcuEf4RFQ2R9XUnScbGWrBDHTEnxTNter24d,true,293305483,293305484,1,1727888971,5638
377,3cEe3SWZJhepuKR3KGqSZAivuiRwmFqsWLZDNU91MHuWUeYNatqJ9Fv3Rn9AR2aTapbuJ6ZTFEQzPdASCbgztP9r,true,293305483,293305484,1,1727888971,5637
373,5JL6Heutt2VkQ3dgzXZP9WAySydM5nhnKbv1m9ogsm7od5UZPTSxePi735JWLQSE53Kf3L837yV3H4gWbpaxunWj,true,293305483,293305484,1,1727888971,5729
374,34kgJ4KUMBTWs7JPqrpA6XV8B1zDGz23JBkitmqu9bJme52xbd9fe5ZNft256WvZ1ERUBZ4QPzp9qbJahPqKZzFw,true,293305483,293305484,1,1727888971,6242
370,3fXevGyfCFrLonqKpqEUKBK53td4Jpv4bjrddaV5cnP78apRZ9Q41fqfuNWFr1NuxLjrNe8P5znAD2pVzj7SeFzB,true,293305483,293305484,1,1727888971,6383
383,2G9UGRtQUVD2CUZAbKR8ZYtjhSo1Z3yKgpXJXgEA9hiAVSdDbH1fZD5VXpTMfXdGU7KHNBbehW5oeEzDKoyeVyE4,true,293305507,293305510,3,1727888981,5423
384,nUeF2CUsXTsugkyWFBowiLhi6LYXjpW24NRWKwHoT6RWgKBefgTDiMqhRasdKcd6AnYL7aZUPXCpFScru1VEhEs,true,293305508,293305510,2,1727888981,5408
380,67SAfDFaTsXnygZNbjaQNRQ3GVo1LmLHAyQrwbNY6RHdY7Zbeq53gCTss3YTem8V5VCf8cLGjMJroaesjfR8bvL5,true,293305509,293305510,1,1727888982,5141
385,5vzUS1CYpzvqXf1YsHbtL9sAG7PJ1fuqePeQho2qJGk11fvLii5M6H2mF7XbEJtWnYakh8tdBYV3h2aF2TKD49G5,true,293305507,293305510,3,1727888981,5641
382,4eu6EibkksPEJ5SWEn5G6YpzHpUogvFLWkLokmKWWLZfUf2JVMJt3WCqggunuA8Qvd5pJnZsJbvkrDsYsTh6z3E,true,293305508,293305510,2,1727888982,5395
388,4N7dYANazuZBbMiKjLiKXvFhegFyQuQWe5wU9yFoxHcydeEbZ38Fh5t8LyoEqUmi83dVPSq4YCPjG7TuZ4bZdPi7,true,293305508,293305510,2,1727888982,5487
386,2qzst7MU3zKiEyyeM7avczPnvCGzNfcQgfs8xB7qwLu7ZnEE1LZe2H9mLnqLwQC2DabFjcZZKbAFy7GNuRxb1X2L,true,293305508,293305510,2,1727888981,5628
387,upk9R22rpKniV98E47rUWzb4GVnoDrrigG1CMAnCAF8xhoivHHrjYzru5ZvXUSMAfwiWgnYgtbEQgkWC1W4qbJL,true,293305508,293305510,2,1727888982,5539
381,3ZaZemVY4NgKbJdb4CcLX2HHGLtyYeBHbq3f3stcXzBuHUmvRM5KW7htvKNDiC9UKrigasqKJjpAynrQhW8yKyPv,true,293305508,293305510,2,1727888981,6567
389,4zyCN49vVdLMf1yYN9Fdc8S8fiBzbej9BFhUbeVGfUPsxqCLJtaeru5REZ2RF5AxzbwcLjrqLUNJi34V5nsLQMgQ,true,293305508,293305510,2,1727888981,8073
396,ybbdxuHRKQfq6RivcD5jJmVQceEa4sDesGRnHoCCtH5nKhAYCKGCTSpfzVkxuijZw8AnXx4EJSz3RNzPh2Jb5ik,true,293305533,293305535,2,1727888992,5426
392,5fiDeEsndrcZHTPBF12i7Fc8GE8JNP9SGxHhgdzaGLvM9UkAgjZrYAmqvh5NbERUAKWpPmeYoR75xQqdSZpLtwBh,true,293305533,293305535,2,1727888992,5432
399,3FJqYqXs1bkdZr9p748Udk9MpPsYUyx96qA6RsPCivPmZk5LGZyYUXMDXcdN7WtbYJoM8d2ZPM2yNMn3rNYr8SUW,true,293305533,293305536,3,1727888992,5354
390,DN9EP8KHvyn2opdxckTF11suZZYRSBBYKbEY8PFwbHmot4ADer7PnrJpuAmiiNT28mrxii1pVqeYcFCA6URSPNj,true,293305534,293305536,2,1727888992,5362
394,2Ycds5yghKLtG7NY9XK4Wq1m2Rc2z1sAGs2Bde54d6bYdrGuCab6MuMkodUoeaBg7zr5asQUtVyguYxKh1vbfSdq,true,293305534,293305536,2,1727888992,5278
393,2nvhuGr7MBfEr7wKEr3CAaQxGVw8K5T9HANcGLQnTt7pNzx8vUenEydBCEsVs5Kfym8iUP9hWohQDLXPmZyzGzAL,true,293305533,293305536,3,1727888992,5416
395,DprQWwGSrCjj7jgHXZk4a3YnjVZ8p7yRSxQFkQCx44Qp3Ef3HU9MBVMptVQwBMEyGiLc5XbT27tTNnb1oWDpt66,true,293305534,293305536,2,1727888992,5369
397,3mZfwq7akokyTVpUYryEeuZau9ndrwotoM7QPadmTzixJRD4qfZ9sbJNgfD6zQaxczNEmkzSpv6xw1oGDo8x2vcn,true,293305534,293305536,2,1727888992,5436
398,suQVF3xwUwfr3p9g1v5wmoKSufB36F8zVm4C9Y91FKkp6SUmrxdYtLWABsuN247obYfRezpxsa6zFQoGgSK48W6,true,293305535,293305536,1,1727888993,5396
391,raQXgEV88Wi8LDTNagqfeJfwFiG6BvBGwdpXQxPcHec6nBRGQi2j4XjnJTxxpAsCHrHNbx1yyK2skN2p2ibDSrD,true,293305538,293305544,6,1727888994,5390
402,4F5hSKXeVsRTgekVKGKa5jnGEmievgx45Yp5QGLz6VCCVte3MrsZAFUUbsCrisGggk1sQsrR7zAKV7fAkymRE8oV,true,293305559,293305560,1,1727889003,5410
401,5fqejb6tFJLyW4dQYGSvkgErBQGembW3WqAMQr33kb7UyTt315VME7nGrV6rJ56q9736Rho9phNMkyZDCXWBmdsA,true,293305559,293305562,3,1727889003,5334
407,5tT78Jfx1S66SFaS73WRN41FkiKvXQ5csHvdFWPx3zbx5j2tTxeXFyJ8j43rs2N1FW3WuuhSFHdjbTEPU5mRd2tz,true,293305559,293305560,1,1727889003,5431
400,5nWYv2Ld5Cw8kjGDfAgu2cWFVjmstbGGeMFbkoS2TVubwAznqwnovq42YQF3YKoaZVY8fGJvTpJtfdgXQHTXpUFH,true,293305559,293305561,2,1727889003,5415
408,5HeBYwWJKoP2Rwm9oWv3zy3HeymiLghhnmEZMg6aX9EK6MqPBEgrcwkMMKXSP1fhczPs7YCLtmzLU3tH6m96wA7f,true,293305559,293305560,1,1727889003,5463
404,4ammRNZXhTm8FTrfmKV6EK1r1jc4rgVgNiDoW7mFRaMGsJiMyyEzF8tQ3tsTJBMR85Vc4Kye8DGM6Wzyd7kuYRhZ,true,293305559,293305560,1,1727889003,5362
403,4ZsYfPufussjwSpZ1NejPMN9tXLz7oFstKGySBH4d8wHP9fdHwHV1biDNaTzkKbhmVUt4qXKT4LgCKa41z1Jxrri,true,293305561,293305562,1,1727889004,5396
409,4wa1LMhMQpkBWKRidb7j2xaecauqv7eWvWBZZ5KGnWQRx4id5bVHgvz2M4qbetqvXTACyWvBTWTiUNGXMY7JGCxb,true,293305561,293305562,1,1727889004,5385
405,2nLEz9tuD91uPBt5By7bgdidfxpTMm7TUWcs2ioZBAMAiGGxQDD1ycw1DQ8KqCXADEtJBbhgiij3jixgmA2A9Tav,true,293305561,293305562,1,1727889004,5511
406,AqMdqLhin3b7EMVnrCSp1teXmzYo5fe1epaZBGo218eYS7QMBSoZQurZH39acCSH3zNDEikpZJgQsT54t1XgGtk,true,293305559,293305568,9,1727889003,10635
418,Failed,false,6969,6969,6969,6969,6969
413,55W5wK36LGaV9dpAQSJSVDLN59AGYGP9gBrkzZt8x43PQ9xeLTT589RuchDV3PcEt1a8oyGCvqJkTet2cw98DQBy,true,293305583,293305584,1,1727889014,5366
417,2AC7ucpUUnyiGKkD4BVvDbhLv7kLhQLV35AF9ebJiPtA8vyFko5zTXYdqXX5JFmwpLjBfWLFKzPYVWxxXtReVkVn,true,293305583,293305584,1,1727889014,5496
412,5f5dhqgQj7ngusrtqVHfyt3zw1tHq4jFdcin6oGHsNA3zfyAYerATpmHRdj5ekGpoPEn9sE34Kzi6fyDAYaugGfU,true,293305583,293305588,5,1727889014,5394
415,4PXmpzU1T5evAPn78D9R9xGQ6Mk9NU1zZpEu28GDbtVQTjCyKazGUnUV3abzyMh7oASFCM5nKZcj8MdawxUYBy9y,true,293305583,293305588,5,1727889015,5385
414,2ovNgo7q3tATi9fmwRtEpVXgaQ7ZNDheGieu7vChDNjHN7cywWQMTF1qJ8uaidXEufRYg3LAriRrx4w7hfS7xX4C,true,293305583,293305588,5,1727889015,5324
416,4X7VGhad1MQ4uiLJLtcW9e38k2KG9ghTV4WqaU1eDs63dJSHyPC2VfRV4m7CwEPdj5cgVwc8xJKNNgRhS6PJ5W4L,true,293305583,293305588,5,1727889014,5436
410,5JofcvfCT4oZb7ottaKB3PyPnjwxfD1VUmvA6fQWWaMpNrZE7eDupkB5nRXH6RAFPeq9mbheELDtmbFZfujxhADY,true,293305583,293305588,5,1727889015,5511
419,4Tfggp1aX6D5n5kxxcCPHuanUeGexNa6meRxdsftAo8D5dYSmXDogLLgMx6TxzLG9r6xVSYkEdPAWdFW7sYD9uX6,true,293305586,293305588,2,1727889016,5375
411,5APwqosutLU75ELoVVjYZNjmRLZWgh5f8XsxMkXTTrzuHVoKPytnesf9A6KYZC2gZ8nYB3umYnutMTGL2Kmp6Dcj,true,293305589,293305592,3,1727889017,5172
422,1F8GvjdjZJP1ZePUANgWXLpAVFW89Li7W4T1WK3yrAwFfqkcRmARQzZjQT6JxgkEENPnQwmHLwZqmuHJqabsB7v,true,293305607,293305608,1,1727889025,5347
424,4QmMB7KeYVCzom4JYB58mtarK26837M1U8a6KpmZEjf3bcKnuc53fhi8hDPPDwtCcGFeMKap8v45dbaFGcWCYaLf,true,293305607,293305608,1,1727889026,5171
423,5a5wziU9J6vGwvAwCXaPjDSn9pJLZLBaGYBD4eucG8JoQQVX1zESQ3542vHFVxzQaKZJchhF9zvXsgQ5paSmpB1p,true,293305607,293305608,1,1727889025,5446
429,3Vd9kW79bYSDdvqWD8rdX5uAPJxCAdLDvkpwCqXzQMxfa71myVeaiKd76yCdNAmpyPbUEKrtqz8SeMCqv69Q9HBD,true,293305607,293305608,1,1727889026,5345
427,4BV4Lkj5Grxnthzdpu2vaVDHSzfGbjtev3dpkCwvMEkZ21LXTTaDJetYZEvqmQ6Tx1xto6TJAUZk752mYzpzu58K,true,293305607,293305608,1,1727889026,5412
428,39VifTRivbRhDzCJVSoYZFY4PztaoH5Ude9AFPbu3p4B4KVkKSRiwwbr6DdBA6tGR8sMy5SGWRgoun2P6inx7Q7q,true,293305607,293305608,1,1727889026,5397
420,4TEuPP5CSoHnMNsQkQbx88H7Zo2hFsk3G1WKHgPpwwZmKn5MoCf9RWMR99ehVAnc1pXH1CnFrpDCnz68b5ZUE35W,true,293305607,293305608,1,1727889026,5488
421,5ej28yrehSM6a9VVBbq4zthLi5e6zZ5GW2AcJR9drDpmf2CMCK95oxVKJ6p7C8DYcdMxaenwcxVsXzyPBM5f3exu,true,293305609,293305612,3,1727889027,5199
425,aKgTqfYfvGWbD7B1MiGreeVfk5eK5vN5HgaATSf4bDPoYyBmrSK85MFBSsDxDw6mFEFqfPV4mYuK96dnQQoyUuq,true,293305607,293305608,1,1727889025,10501
426,4AyvU5y19mCFrQceKGdjmkyUckJCYDDxXquVh5DjP3dwFtr2E2CnGAut2VQMciRkVuG1xp7HYJyKSoM5pB2tE7L7,true,293305607,293305608,1,1727889026,10668
436,3RCHvDLMHDZopVvCAohiDxUinqnahSnFr2tHsd8cMqMY22NdA5KnPyCzhNy6N8ikPthTJtJhgZ5snHxawfThR85Y,true,293305628,293305632,4,1727889036,5294
431,QG55SSUhaNTg3TYW67eyG1zJfTEKD8FqTy4jcwKgx5fGytcnzY4VmusCro9SxZG1aXYe8jHLgUF1UGhvMe3upMB,true,293305628,293305632,4,1727889036,5206
435,26NyQxfw3PhJ8UajcDGEXEJsYYWPpmDkagEtn2GJMiN45HUJBdpRTLNWVvgSNukgUzR4sTaQ9QLoQEq99naYJiyQ,true,293305628,293305632,4,1727889036,5366
438,KWwWrBxiGKpL9uZbfCeZwA3MNK23fvZBBT9UEjhy6oapa3kLx1U54v4jiismk7US7wkhK6LWsSGFaojArwoZyWs,true,293305628,293305632,4,1727889036,5372
430,46Yi7mswiZpdxSMdwCKfYFVaCvzEEtXBvQ59y6RujfXtLSAZGTg3mCYdJDJzKHvXtMKiayfY83ukXCVX64csa6kv,true,293305628,293305632,4,1727889036,5349
439,33BN9hNokx8aT6d8BnP3xD9bwTzdsLojsR1RQ2boQ1t3UwfS7y3sobmbCyNVwHjorGfE4wSUaBYBiLKJaZuD31gT,true,293305628,293305632,4,1727889036,5349
437,3WNTAuqkixHNTXLeuobPURBU58ow8KMopDY4MMsqcAiXjJHNUe2EfPVtwmgke1Hr2DWmPoTo2DKpQeHt6QjV1ahQ,true,293305628,293305632,4,1727889036,5421
434,YhaTzTaL7PaqL3gPLKpNEC5bzp2quQkRbarTUAYB1BBbb8uZJBMcpxiyMnivrkzjmg9rXCHSzLJxMjfQ53byCSj,true,293305628,293305632,4,1727889036,5734
432,5Kf1VCUPpXs6Qk7dx38A9K6sbzBEW7sgjKoDmdTVhuvpurMDs4ZH66g4PScGF3pF88T4n9n5p1SNZJUxzUxnBDLG,true,293305631,293305632,1,1727889037,5202
433,zcmJz6sdaD2hs6xzq1MNAr5vo67xJSGP3YAm2Li8dkyK8SMmMMzyUgYqaStBWQQ6wFadaT9oxAa2z7BXvp1GdPB,true,293305628,293305632,4,1727889036,10594
449,3BPQNhysAtKNuUwcoKNZSJpsruHiGZQnz6RExYJmG2u74QFpvRMQEJpcHc2NnKhjmtBVzXciESFpo3HWw5f1froC,true,293305646,293305652,6,1727889047,5276
448,5sRnyUYcFXNgqNUW2EYbYBA5nJ3MHrTa7Yodhk5dZqSxaTvDyxaBjQRwHx69AF7qaHKfwZ53nLNMCCMmuYjtBjwV,true,293305650,293305652,2,1727889047,5184
446,qjikxtGmJNDaJbW2wyMNNZxrpjmKNJPpcqrnJUoTs24CoKSnE4rpiV2atqvR2V2oh4Rck7F5L4St9cPNXbby5iM,true,293305650,293305652,2,1727889047,5205
447,6s4sBfT7yJsRibuYe9N6kdzmT32KaxCpPjowvC68N4bw2m81bkAJWE8gJYPay2RCvaDPREsg1L9iJGMSqstJwHr,true,293305650,293305652,2,1727889047,5196
445,3q9cCMp2Wufd7dhcBfFP4N7HGKBzALAuXd4JaW4azRnXds91WB3Sbs8HoPXRZ5DLNepHj3zDnmCAioHNHagQHcoV,true,293305650,293305652,2,1727889047,5281
442,uujKT9UTLXFHdwzkFdnjtZBCbVGK9k2S3y1oYvRtKkGJGDm8jtqSL7Jw9D4VRZvYrVLRSM52zxx1gmRTmHa7np8,true,293305646,293305652,6,1727889047,5488
443,5bCs1NJWkSEAe1oYoTZBKkkEDbQRmjRkKgG82oYCcjeePSF7DEq8faRGKqSdmdArsMajqqXYrKoSLnuVkzzj3KUC,true,293305650,293305652,2,1727889047,5174
441,jtCRoEqz7cnJvaKF8KWjvBuVtBVXTVnVmxofXQrRbdJqJw4xfFRC3yz93wvZmCRF7PFUtzKveRG64nWZTaQsvAe,true,293305650,293305652,2,1727889047,5421
440,4KESMQogd2NhaRHNWscR1BqH2na2m8c7KDadzj92aWJuaWyTuzWaqeyTwqQ1AooxbnGYfXh9QeHzsjd4DdcMFcfm,true,293305647,293305656,9,1727889048,5384
444,5q5dGQcezJiQEQNySFwDk12g6DbZ83RrCDFd9JTQAVoTCbwVaDHqi3UqvYeKkQomB7ikxofu4Y9JZyXif4sGQPia,true,293305654,293305656,2,1727889049,5348
459,39LY1csDxpN5p24W9jeAvaoHdERbTPPhyN7ctKgucgaNcBHJARsRnDsQWD4gXXLBBxTy24RoAxxJadYWpbGZFcxR,true,293305673,293305676,3,1727889058,5196
458,48MWMV3ojEFWki8PMshpkKaMDBiGHSTvYdpQug8qTGwkLZ6r42BK6tjeXnbCJ2KkmPUH3rJBaEGvzmAuneGqaJBV,true,293305673,293305676,3,1727889058,5217
452,4pPMwPS86ENedUUgxAdeNnct8dCwviDhN6gg5Zo2BZwY1AWTFNNJsSpnmTJFyaQxuDTEs1vf1Z1jkaWciPenWMtn,true,293305673,293305676,3,1727889058,5194
455,422FaJRGhFiVykvBP87eaHti8yUwyR8NSpdNL7iCuAeLEs2CEyXSQr6qioiNhpoeQRQSmyCBcVQJ77mRjoq5hdXi,true,293305673,293305676,3,1727889058,5202
450,4FNxMgNQ128orW8LYVZs3y2xVkxjkpbrHaSbcH7GH8G36uQkZrimZgcmacaEaWvgayGnBuV3eLhvS358yFPZzwZ9,true,293305673,293305676,3,1727889058,5243
457,5w8Fq6sQ15AqhRbqGdAXmSvVJqAo2JWnQwwmQHWvyv2FJ2994ughDReCSgpiBhJHQ3praSthsgpcgcK2X7Dsimdm,true,293305674,293305676,2,1727889058,5213
456,nK62Zj2jdBvw4ovCfyRnPsRxraxRhjSLomoeUzfGcmfEg1Xy6HnwnUYhWwjR843PdQGiso7gg7o8Yd9jUmkQBmZ,true,293305673,293305676,3,1727889058,5347
451,5xvy5vWP8ZsbgdFFiWkA7ABefMt57jemg4p3GavYASS5KQu2mibQVpybxwfxw1E6n1Dn4rjxjcEkZYLoPdfVsf2c,true,293305674,293305676,2,1727889058,5181
454,bz94MXcsY6BpCgDR8Co3VU9VsqFy86iozj2yu9MEFeH3t93gizUKScmD8LXHmZrPxJhzbB8uRy3XNvCyTne3VDX,true,293305674,293305676,2,1727889058,5355
453,5eTm4gUETHP1JVnpWmUz3VQNnqWKCY4veK4Wx16KJFQxUGtFaiinHQbFD2DDkBT3KesahqqBvt5dXdE36Ffmxadb,true,293305674,293305676,2,1727889058,5315
469,485sm6JAtXvLrdSA76tWHvkmwPusABuNBWYKKPELp7WR6zWBKTsmrtzdXdKRg21ukjaFv77e1KJg3uqYA8Qax4L3,true,293305697,293305700,3,1727889069,5183
465,G7X1TUy2DDmfJNnEuV2JePMH9jY3ce661aAMnVWqVw1h92mEo5z7TCxpeGB6ZxpgGGt4oXqn6Lxm91Wykg8ayx1,true,293305697,293305700,3,1727889069,5190
464,2zeEogdt14iGD1nkmxJQTFyqHxheRQsaGwskjxA1pgbWQgSpkK7Pb9jPkEH6dM2NhceRQYh1hxJB453khx2haHD3,true,293305697,293305700,3,1727889069,5207
460,PBXkxyMuNrWtdf9CyLA7UX2pM3Vt2BMsusLNqAtiPTaB45Ba1sam5d9x2CHQzDWBnXDjgoTTHD4cDh9ZEzgJXps,true,293305697,293305700,3,1727889069,5184
462,2kduup9qs4ti3ieis7uRqdXFha3vpK7ETX8qkjedpe2rj2e42iQ8RzV6ZWqEomuf6qExFD4HFvjRUST3CQNmTivM,true,293305697,293305700,3,1727889069,5228
466,2BwYV7VZXPCY7SBiyHN6ksoNrLq6kLRYyBfXoxbirjfmwsy2owhFtTY2NhcQiQt7mgnUXY1U9FpDPBc5eBUQiBx,true,293305697,293305700,3,1727889069,5195
463,4JpXGyzW7EFktbqT1StpZVtKzP6fikzisLD7LUiBjcWdjHaKR9TKLLEq5XttB5ZMULJ2fS8po5Cc3ZxuXh6RdBnf,true,293305698,293305700,2,1727889069,5207
468,358yFFLN9Viq1KNWRRmdfyCEqA9fDHkkNX4NDYCk1MLZSwd97vGnn9BtFyqugQ8K96bZxfo86PRaSyijETFYyaz9,true,293305697,293305700,3,1727889069,5341
461,4A9CXDwEnUmLQuWDEuMwcSKtCQkJec5pFuXw9MXAgrz6TQ4o72JNQSieuGMNPbpuTd5F2Hv8pnYDkQP6i4iyjaGK,true,293305697,293305700,3,1727889069,5400
467,2c6TQ1fuBemQ9jU6iv9z3NvBU7ip7eZtovNZ4TUpTqgzSMW3wDDrNzsHMpWJbksT1Lw5cX8Kg75VPUgEU1oL7Cr4,true,293305697,293305700,3,1727889069,5452
472,Failed,false,6969,6969,6969,6969,6969
473,DXw7LwnsKi3v6B1A5h47K5M3Tff4o5eNt7PMchUc9LfmZq8jAgceJCTVQ19snVvQKs7e8459DoGWLGw1zSb4AQN,true,293305718,293305720,2,1727889079,5183
475,DqDsTCeEVRqUwSWXfV9qRaGsQx4B6onvGspKM8mYkNJworLtzf8NyiMnbKTB7dNG1k9jAtbQvbszj93qfeYN9A5,true,293305718,293305720,2,1727889079,5207
479,4gQvu3xfkRrfuwteQjfSyTNWf4FjtzLQbFEuMbtR9oEg3RjKzJG6WJ15nC3GABJ1RdmFz1aZ2TCygGxr996QFj77,true,293305718,293305720,2,1727889079,5201
478,NtLwwTDJc13CRHws71ajdPFQy6wSj32iyTf7zsZMmvv7ymTv1YJz9SnJ3gpQQso4W8s6phVsGw4mYFydYenm73q,true,293305717,293305720,3,1727889079,5353
470,219kZ7wA91b3DUQvprsfnp6PBujfCeCUz3gqgaSCj5HgdB96eVvgRHRieSjY8HXZjMGLup5LmBxFdNBogGcCVVyz,true,293305717,293305720,3,1727889079,5369
471,xz8Ef6tYqvS8xjXWk3YzyhVyRv2wPUT783Lu3PhrfhB4wYw49Zszyg9aJLsnY3g5Ex5RV2wvTR5njbMPsmdywid,true,293305718,293305720,2,1727889080,5206
477,NrFRXKGcsv7tcnihs647pPonPpHuDqp3t9msb76VPtpmhzxS8t2t8FSCMecBYqcgVodqHZfVy9d1vXuaFkjJVbx,true,293305718,293305720,2,1727889079,5355
476,51x8vwkMHUJCYioVv5Yfw5pHwj1CKSqTJncuPChS4Yn1G3fFfgPmktxDhAoy6Q3nizWXLoTVRDavgMTkHshpf9ed,true,293305718,293305720,2,1727889080,5375
474,2sjA5fz982Hy7F4mMJqtJwZyLe2fyCtMHvWQbbWLUgttvrvWKkHhtFydfWvpsRAqiWm1xmeZnfZ6dvgtX7RniM7k,true,293305719,293305723,4,1727889080,5341
484,gVwNpsqJzDi85KYqp8hde8GZ8RpwQMko3AkrK54uFZnjQH8jNuFmwHJnD8m25LAyCqzKU6WN9R27feUr4jae2eb,true,293305741,293305746,5,1727889090,5583
486,3MuqBRCM2ZRkTA8ff5bZysZhV7b97wnKuRbqNZTcXKs7KDkW5rbEpnZjCgr185jxzweC3FYXoiaMpFWcYgpQAeQd,true,293305742,293305744,2,1727889091,5425
483,E6ccaZekYJKnd98L9my4WU6Uc6AswQwYychNe3H1yoEjxNkKD8tCtCnP6uPL7G1vhQE3EjuHm5bGbfxcCdNa9jf,true,293305741,293305756,15,1727889090,10255
487,2pVWwP8UcnfRALCNFWHXYsfuj59qMa4i45e5onETiZt3oaLHo6XXbhCmqKRyQsiJDMzGcDHjsDu6iPx3TbsUZGiy,true,293305741,293305756,15,1727889090,10650
485,2VvQbmiwiNk56oXRoyax32PitJyvcGyaxYwCEmM9jeegRz4fF9yWr9FanZ2id3EdophhANhEwxsGEFMQJL56znSQ,true,293305741,293305757,16,1727889090,10659
481,3GCRvKxAHjsS7yJtQu3UMru9pwNTrHMjXXFZwyXkiaaBA6Yi5BkZ3gGkdHFmvmFvSuLvNe1hpGT7vGtZDYRf5C4L,true,293305741,293305756,15,1727889090,10827
480,5UBsQiAmSenafGTK7U5nTWfRDJH7xF2AgWAzEtz71cyA5V7QoDeBvgn2ZdKh2FXyGvVAaybjNVHXbYqG1qUpcqcE,true,293305741,293305756,15,1727889090,10976
489,37WerDLC55dWikovfiiC1vrPYFbDXkfcWvN6u672tQqLdrR4wcXKm3e9ptveqcvFKouj2Xip3X4ENZfo87YEMY6x,true,293305741,293305756,15,1727889090,11038
488,2Th7JKpLL8nyQzVwiA2dUPjmhLtbEGzBkFqvhctoZRY8DJcAsuANNmyh6hGmBQbhBdMSJQzyXNVTVEpdqB166joY,true,293305742,293305757,15,1727889090,10951
482,hjxGxDF7vBx6BQYqU8Vcco6BDSidALGfWaG4Ti6NhmwummcmGnUyfXBPfnWxwX6XLXywPDeRoUp2U8MTXLjDBto,true,293305741,293305756,15,1727889090,11509
494,3d9zhTfz5Y4NhKW9z5Zw3WsMmU2np7dxrmNgqVvxtGNk6BbtsYdKu5LeJbjz9aJXdSKpGeMeQut3GEGRveEUMXhA,true,293305762,293305765,3,1727889101,5525
496,5LAkue1JGUTCZqxfdyatNsN3chpCHEzbiy23MPpTag8Jt8uHJJMocGAqZYMYT8GuTEqsPmpufEuXDWQJ3xmFXrV1,true,293305762,293305765,3,1727889101,5574
495,361mSb4jeoqyQRsYT7kXhS5tWWVAowNqNyjdwBybyLGegrckynxbYgUrM4aMy2VNrSBmrxi2vW2Y3DsQM41TLHBt,true,293305762,293305764,2,1727889101,5600
497,4rHeNqkdRhvEPDh8LVvZfSj9rDAeiwVpEQ1hZFifA28SC9bT1a9zNUczXwrfiXiSa1wcW5JDYGkfaBBbUSPMFaoG,true,293305762,293305767,5,1727889101,5588
499,4ctXY6MxSjAAKxghXtFdzRFBoyyqGgQT6N1eRBbkNtscajwC49LQpk8Wbjn3D4Xu7Bnmzco85JE6pFBUNAtGdDrD,true,293305762,293305765,3,1727889101,5629
490,4Re86PFbHDb3q2F8cie6h4cAGxASqhdmDbAgyWjqXpA1nvrZQfzJMeU5YpojzwAzbcmFFNtco4CiL7XNFrP5QnSq,true,293305762,293305766,4,1727889101,5451
492,2JYsFXTRtqv64eM1pqn95HgBmnEa1zhd7Dsx6dmAD32HxXbzqLASkeiHVnydARvSNh61gYd4AyWs1ax64BSmTVjW,true,293305763,293305766,3,1727889101,5693
498,4dJXZEYXkaBi2TX3Vv7MCjAqfBRsWhPZCHQdizJSHiQU2TgndskLQVeczFod1QuoDQPzmPRSvHf2ZNV86iiH7cSW,true,293305762,293305764,2,1727889101,6335
493,2CAjUPjTzL7gqMA2cKFBaa5NrZtppDfoQachuk4fqPXbVXLPtD2u3Fnji8eYVEVa8gnX4RTMjFFJNcEhR4t5Crj9,true,293305762,293305765,3,1727889101,6407
491,3ow3RqFfNN2o5LaBQZiLVb3X38gBoUKUb6pyDRw1atEf7Dr3cgD2Ye9GqLUbRgxfRwV9V5AcWzXKDfaALUoSgfgw,true,293305765,293305768,3,1727889102,5766
>>>>>>> a1dee7a (lol)
