id,txn_id,status,get_slot,landed_slot,slot_delta,time_at_txn_sent,time_taken_processed
10,5TpvJupjpBP6LfFDVgV5cWk5gawmW4WczgjsvXEPzJbtjwmvNSTg6UmiGJup5akVDH6WUw1LZpqeAB8ovAcREwQH,true,293321914,293321924,10,1727896535,5479
14,2SRqXRa4yPMsQAHqVbonEWZjtFbKbXieQuhfHtzViKT575jszS2Z7sETwuRb8ELLZkxoAS3erV5mtXyRg6AK9xjA,true,293321914,293321924,10,1727896535,5525
18,2GFmnSnDrUHKw2sWrH9UkMSWQTfMAELakbZQFmFgGwUHA9KCCwSn7bSHU7G961mY5PkaJ8B3B7khFRmXr9xHqSzt,true,293321915,293321928,13,1727896535,10625
13,4CFCm7zMZhYWku2dKccBhuvktojU66KAW7uvfaERAM76SZN1U865zCSz2nMeMNE69xa14TYcn1my7cP79aECuxr3,true,293321914,293321928,14,1727896535,10837
17,4DxAZVPDFyLmZdw44M7RyLi3iKM8BXbH1CnYANQa8LCAipF8eDbVfezxwrvpQzm6rJQfh5uNmgKTjJMRmErqB4dB,true,293321914,293321928,14,1727896535,10865
16,oZKXdFY4C7GgFAgJBkvC8n5mgyb5h8puXDbjHcXq169tFE4wq9xJCjg4vtazxHYegUEjYiBywwtPa9RHRNJEXWD,true,293321915,293321928,13,1727896535,10860
19,JNKu4wAGfbAze3NzbQ7PtvgBuyEHsXsaFDAuqzXBbLWRjVpySmvNdciueFKywcgC1Nmdfk8mJetny5riDbvHJcZ,true,293321915,293321928,13,1727896535,10864
15,2vtK9uZ7XecSf5iAXZXcH7E8tfbtUvmYvnwHUNi55k4ibTfosDAxwAQM1uNWpS1rX6wyRQ4MVLxNzXviEDmQhhpP,true,293321914,293321940,26,1727896535,15418
12,25N5LBFfnyEweyVX8sSSbaavYfRTLmVtEeQpj7kPcg1RpmroUqKBMYcBFgVXmb7vu45bRMK3eUQftpuKqHZW9FXv,true,293321914,293321940,26,1727896535,15852
27,5yodkuN5WGUd3NrfBSZEr1KpEzSkUV4LKPygFrrek6i8v3v3PA8Fm3L3myudbmw8tbfuG3pk4NAXSiryKyYth1hZ,true,293321939,293321951,12,1727896545,10354
26,4nP6U2p1KWzPjXjKWgYsZj3yQ16Kd42VYdka7SGUGmiR3kuqfTasK4WKnujJyMBZkehHEyxBhMtABrwyLPxcm7yE,true,293321939,293321951,12,1727896545,10394
23,jf9e1d2pi1h8e5hG3tF6czo82gsLmM7dUhQPYizoWnFdQ2Wexq2wqK9GZcKHh7ZbDJYS3VRN2ZEPjNFxD8DGawv,true,293321939,293321951,12,1727896545,10477
22,HbiaBQgAT8dS8n5zYdAbLU14FwPxwF8BvzJWKo5n4KXZR9V7pme5aDcW4qpfUCNz11XZLDUj1jKhxp3WskbZXfp,true,293321939,293321951,12,1727896545,10604
29,21JHdrjCByXDtKu7MPvzpfYhk4zokYyeLPF3biXo6APKAJAuUFXaJtzWMpwkjiHD885ZbwESq4p9RRNSgDdFMYHB,true,293321939,293321951,12,1727896545,10620
21,sWwCEXrxdb7FRCKjrx8DrrggxKXnwcy17atEyMSxxTz5uQHE1L7c5EBcbHn2F891dE9DyGKjaaouKU4JrZXw3fG,true,293321939,293321951,12,1727896545,10611
24,2xpwF17j2kS5XpRCTVM9yn9vvUL95mSHz3cTyKkSRcwj23mg2yLre4GXdmgVvRY1jYvbwyWMAatazrzSebj58n61,true,293321939,293321951,12,1727896545,10614
28,21MTKLFsfN2GrzZSFzyXL2mLF9vCFCjH4w7hPyqL9d8Vz6dyXATraDHjSGBYCYFR14G1LdkzTdskVHsdgv7os8kY,true,293321939,293321951,12,1727896545,10803
20,JbF5tTpjZTLUe8CAVUg3iS2w5TtZ3xiQSsvv4dVroSKHAmjw9VS2ZgkPooFZ4N4az3pVK92oKZ6BJQXK9YbXpAt,true,293321939,293321951,12,1727896545,10860
25,4i7RYUCcUEPmqZ71ekpUHDXFHYAeQqKWYNwkWPjZ2CyPn6YWu2moA63AUYTMtCNYNyBvdCFfPzQjijPLPr8Mjuhw,true,293321939,293321951,12,1727896545,10887
30,5Ki65TSWWGexTh327ycPQricpipGMwCiTBEVakQBi72RHcBDfbtwPpc4sGAxkUr3S1GiMGCEGPdTc1ks5pvhoAmu,true,293321959,293321964,5,1727896556,5186
34,311PvA4CWz1BWVzJwUiHDmE4crDEdRbhHxcQvgUeAKDbKJiBGXiqozfUBWZLtM6zRbiHWimHPBQsCrcA8BjGkvfE,true,293321959,293321964,5,1727896556,5195
33,3NLaBkFWB2bsPdp2FATp9qKs6nd7QYZNKaXK8JzZvBghwZVCLps78Wck3uyR2kM8jR47HRrkDB33vbFuc7nMHQDv,true,293321959,293321964,5,1727896556,5205
32,BBPx9VGJJQbS6MSFZ6D1A5kqVfoxeTgJfSEUNifXEaz4YRdAUzws39pBUtZoazpfZvMfFZt4wA3X93AKnShWGv5,true,293321959,293321964,5,1727896556,5290
31,4aPkYx8BZsNcww6JXUshmqYFk7J1yUJDVYFFdBtH5WivKZ4y27MQEv3Jh5oQPaafRjSzQJ5Uf9ye8BmB7feA3vPM,true,293321959,293321964,5,1727896556,5416
37,W4Y7HwQkvpMHbRncDNsFrCM78aNdFMf9NmqtrMPgxRmKRF5vXH8BKgcvZNTgBfNbGcWtPTr6Amv3kRZenFZTqD3,true,293321959,293321964,5,1727896556,5458
39,5ahK8ndUWP6PGKUzqMxb7rJQA1v7ZYTpLWBAa4r1GuTgmEzBYF9A3Rgi5DXoqz2vjZhn5xJdxfsVAt8sjh8h7ofZ,true,293321959,293321964,5,1727896556,5467
38,4jtTQGqfUUgWKwKF8gP3CymUxo4KA6EweWJJJTZFT8TM6YsaXtoAfJA8W7PzavSDGoNgu6YaKyr9xgBkmiSfN5ky,true,293321959,293321964,5,1727896556,5471
35,Yo7QysgeyeE22HXz6vXBAtAtqB8cdWRyp53DJkY7YDc259jbpTbj2wt6QemmqWyerMQQpoKz5vTw8RH31SPiDuh,true,293321959,293321964,5,1727896556,5555
36,3VqH1UotP4Br85XZ8jEcVGE2w3hB6gJyYW1R57yjzJPMhfuByqseJsmt89J286siaR8JDfxzkadE31brzwqrZJ83,true,293321959,293321964,5,1727896556,5615
45,sWpiWo259U7XrCBTuqSP5qLaPmNwbUGwWJMnjxasZtUT4xHstfi8vFBjzczrShQadYuvEP3cQVVXkPZbjNz653A,true,293321985,293321988,3,1727896566,5173
48,FdeNFq2Di3n8J7FE1EfRKcbnyL8xnLsGA9LdPtjUXfZ21M1hBTvWe6gMHb33Cwvu9BFMR4EofpRQNxtFY2jvxY5,true,293321985,293321988,3,1727896566,5171
42,4Ds4mMg1pEXYBZkaBnED6VsHcDh7vZdebMgBw64cNyQvAqiPA8ouV8x3cQWV9Tye7KaGAk5QoPoUgWDcFE6fAeaj,true,293321985,293321988,3,1727896566,5204
46,3PDKwB6RjyfhAfojeb49i9o7JvbMzemFHsub4Va5QKVMkdHSAesrbQxYXm7LuPDoVpbSzfKXkqz8JTbNRhpKZbpR,true,293321985,293321988,3,1727896566,5199
49,58wA5uhie6Hd7ioS5VZxb1wdgpWhw2Dq1xiCVxG4e6YDeQkYjVKQk9HCfgzsomrnsirJmiAHt7UZMiBFhq7TKPk4,true,293321985,293321988,3,1727896566,5207
43,2jvkW6fbdDLnN7RNGyfr7cuD1XnJfcXrQgXtMruYayvRQ5nfCZUYgsocES8RBYNop1qxHWsomM9uTrF7miat2GpL,true,293321985,293321988,3,1727896566,5221
40,4dJwpwA6q54mPpWstexB2SHe1eweyZCahscuRmBzZCFzWoCfE614kEPNdPqiP9dcbp5kG66ePUKs5eyXNAJJHvS1,true,293321985,293321988,3,1727896566,5295
44,39ejCbmRu9HZm3nXjw3rVS4GyZAiSd29iuoRfQc5E1HkQ2A67DGgXctH8fauh4BMQ1VDT1Lo3QMFKRhHWZX6WLrm,true,293321985,293321988,3,1727896566,5462
47,CNb8gkCP5AGVqX7XTQPxcUkfcD8m3dPFPk5g7e5bWd686QmAZn7Z8vwejSJRG7JkbUC6Cd397AP4idBza6Aabjf,true,293321985,293321988,3,1727896566,5482
41,tQcF5TU1k34RYtMHyYrNUowBAWpdW31vvRPDhGg5tfTPRKEXsSUQ9Uw6tcR7AKGZnVJf5w6uacW1YmbjSnwBXeS,true,293321985,293321988,3,1727896566,5506
56,2mQKbLfAUuiiKyRXoHjo2Qjo7g4ujKTssSKGpY37pQyD5Dd3kvK91Hj1bkSZ28nQAddUzzWQm56TbHEwQMrW91bd,true,293322003,293322008,5,1727896577,5226
58,4bWmqf7kaeQM5xFUefDXBLJqqmubSdDSsUg5qbkqJcdajbD4KvzE5M5LsoN8FtgqUusJTD5CD42CKUx9UHMUzgug,true,293322003,293322008,5,1727896577,5246
55,5gQub4i3ntV7ipfCmmFWdHakjGPE78dRL3WnfSGpQvic13G7iJP1Jx57SLY7XPX14UpPLqpW2WVTn55gNZGRzdfT,true,293322003,293322008,5,1727896577,5251
53,2E6gogysxdrYAYZYpVqfAsfekhn4gSM3Qk5NJizrLe7QTkp5rUZwrkqa6EF3ZYFngrsGJGd4hNF7boArMwD9SEyV,true,293322003,293322008,5,1727896577,5337
50,2buBc3k47mH9zbv67GPrcvkjn65sfGHBz82YAbdiGjoymcg7BUqNkDEuEAzDMgKb8c3nJ5TwPPvuXFsemBTWduCG,true,293322003,293322008,5,1727896577,5436
54,2dgNaRRDFx1q85uQLswCrcUVWdCGfcEuVwN95Quii96jdjX363iivptQdYj39xE3WpsdugwiUEg24KArdYh6SyKM,true,293322003,293322008,5,1727896577,5461
57,4S4rfd55NKU74hUmuxxWZouH9CMpECH7UcPck4BQzM22bkVLKZr3Ao2dHVmv7PnwBuNUPBuX36ghgF94yZiNeofv,true,293322003,293322008,5,1727896577,5478
51,2HLBZi7d8ZWSaEmhMDHdJCRPdevGFH8jxLdqKUmr97NXxJz4TV2Y48cqyozU8mu5HouN6eZJRiAx2xdVp6vvxHXn,true,293322003,293322008,5,1727896577,5520
52,2ji2PoK6n1KgGyJJ9twn4SBpTCq1evdvJuVkZbMhioZVrByGFCzK5Nm6sMLbnq9AzLcRSeVgF5Y5mvLpMwaT2dJq,true,293322003,293322008,5,1727896577,5530
59,3ESbxqunAqU6BsiDzWGBX8K8CNaFxpZV5VRvBnvtpAPYF8yedWjER3jTBeNwSGMAi11qkrWqd6oeKb4T1oNX63R4,true,293322003,293322008,5,1727896577,5559
9,B4JwZMWEohomVzvQfdaKnGktDZGY2TCbBmRmEYAr9U1VZM2ZULRQKfFoi2Ss2eTp4xkXfhpxPPLe5pdWDNkFQKz,false,293321891,6969,18446744073416236694,1727896524,61539
0,4nChmB4kx2hrZbrmGEcB7bg9dUYnVknjHRMsUte8BdkeV9Rh68Fx9nSu36pb9rpEtN1zKHyaGRDADapqvaV2fDYR,false,293321891,6969,18446744073416236694,1727896524,61721
1,3aJbHvqyjeSXx5718T7LrCZ2QwVJWq3gdwB6iq5CVE49nFLBPiVTzXaNkg5psu4iPoZbVV5LVSxnBDkrY1nnzSUF,false,293321891,6969,18446744073416236694,1727896524,61861
8,tHhMRzNL7F7cDM75dbZ3aQtVq8pHzo1gyauwCmyTm8jETHs6uHDiLdDkc5dcxDNkL2jwps72sjXQewoQavPhsa6,false,293321891,6969,18446744073416236694,1727896524,61910
6,2QDYav3UCL9Y24ZYS6KnaoAM47Mw77ftkpPKVsJXDKpwqpiGfmp9DVk8VLipJf4ui1PGLr1KP5ZKrU3G5Wu2y6Mx,false,293321891,6969,18446744073416236694,1727896524,61997
3,4k3QEqVixdZe56i3W1QKvqCYwkDJcjfqXZUxs3t97Kcb3SJSHzdR2cJ4bq6rkbocLEka7zE3EL2ey3GLyx3FxTz1,false,293321891,6969,18446744073416236694,1727896524,62063
4,GRsJFRszCHfgnmxb8cdkfPftSZEiSrwHkpEZkgqVVy3aeL1dt1W647jqguJ9Xh1vcegr2WWJNhzgF62E9EDt5mg,false,293321891,6969,18446744073416236694,1727896524,62325
7,3v5J5Ynw7Z5EvcFCa5Usn2hJsGsggzMfcCFawY1wRK99EA37vrimmnhtFEFasAnV1PxMpkLL9NaN225MWkBPYNdo,false,293321891,6969,18446744073416236694,1727896524,62429
2,5rJYR3nLCMmn9dXBon1466D9XKjJGeXQpMAWeRB24oFaARwYv63EbWKD5Lcu2cayQJ9nfRmCfiCYz3Cxcgqfj7zR,false,293321891,6969,18446744073416236694,1727896524,62459
5,2oEbWoJE1sBTrYPjquBoXD1JSHfPbL5BqwAh39bDRnM5fnMhQh6iQyNorXMckofcRd1PQxd7FiUJdte7ofFR12hM,false,293321891,6969,18446744073416236694,1727896524,62490
68,pGM8ga5rd8uE3VVPZwHTWQiMDWUBoccbzuoCAkpqGhKmtvbg7CLsESzeB3SL9xZBfaAfrE6VVNGDaKf4GuPbTTE,true,293322029,293322036,7,1727896587,5184
69,Qfa6ndkxvBSE8CHxAyK8APbAjjwzKD4rxiH9BH5uEkR7195kZt5JEFRqqsGh8ag8PpyR9uiXsacUhSABCqgLTw2,true,293322029,293322035,6,1727896587,5194
65,3DR1MewJthuAjo3QGMyDjWfB7tNDNuUNoCTc5mqAEsm6g4SBjkHkiNSeDLMtzZar1NFj1tLj77hV9Bm443HnuS84,true,293322029,293322033,4,1727896587,5272
66,3nLdekUsYHVDdYiNkQtMb1YfJxE1igYV91Ln5nfeQ25VKWHFDZEFV6QAxNg7ZpJPp8rPZ9VxH7ETV1rgaiDEvzWR,true,293322029,293322033,4,1727896587,5451
62,3XoN8L13vAN7SJqer2SdHPa5L4PMLtvA7wnuSSxtGrEcFTk2DXcLKCTSY7TQbAwdFv8feFymnZo1H3DNL2Uj2koa,true,293322029,293322032,3,1727896587,5451
67,5GJWhq1KVn3btmN9eV6anrhckFwPrBEuQfpfKo9G8A2PYaVgb26jR9LBf3kNWs2TUdZpwj1r2ia6tgisNWgc1NbH,true,293322029,293322033,4,1727896587,5750
11,xvtdT7fDGDYiBwKHnqGGEwHX4XMg1AP6FtPxGq1XAMv2EAE1FoyQ5jxxJEKB9b5HzDxf9isfiQ2GXGZS5kat9RC,false,293321915,6969,18446744073416236670,1727896535,61939
64,5ZamVqUnJSYkwPAK3ZJc8Rs4tJrAJsgRdanr86o7Fh26TXoQ4cCSpv1dwU1AFZTSXjRX2nKLGnrj1Fqti6hCpRkZ,true,293322029,293322040,11,1727896587,10430
60,5kyqFp5jhPeaiPqoedrx6vc2VJXw6pHLUG774jLowNA391Gh5EoQXXtBZTfqgeA8GeKUk3PD5kd4fhBHUz8hs4AX,true,293322029,293322040,11,1727896587,10423
63,5t9XMjqzPWsBBihJfZn9QW82TGxk11Txj1UrcXxMGaWBYpuZkPepP9K5SuUpoypLuo4shaLiVzEQEHFXTjqT5uqT,true,293322029,293322040,11,1727896587,10526
61,48NutDZPsB2FVGJS6k5HCWGdxJTP1Uyzzsp5pnaHdgeRzwrQWcKkU2v1ntoFx2kppmqE4S5AEsiiKJDEHb1G3ieZ,true,293322029,293322040,11,1727896587,10584
72,28QHsufec1zMNaNPcc4MvSkrfSg4h3hypF47s2KzeRdh5r7u5ss3Yxyp47KAGk28eL8muBGWChwBHarsTtm8Uis9,true,293322052,293322056,4,1727896598,5207
71,3CpfCcSJ89siCZr7j1HdLXC3gM4cqG26dv5j39SDV6gyBvGdQy8F3JQskcBC9MsP81i4QvUcwkFiGZ9uWJuGvDbm,true,293322052,293322056,4,1727896598,5208
77,5PDfrJhsUXCgnB8D2S9CdFNRWPBY6RKVkcHpuPicyWyDMxruDwFdzsoBAC87gur7ofjEpUz9w5zioUdGKuiM6PFX,true,293322052,293322056,4,1727896598,5221
74,3Fq2Pw3LttextPMQngsGNiYWVrZmNKhZgTVKbKeK7KG12eowcdNSzQp67giqDcoQJSqRsgwCNWVTi3cKpLMhyc5n,true,293322052,293322056,4,1727896598,5294
73,4x6Y2SAv3psCYmPnzeZuAX2M1NbxsJ7R1iaF6fLoUiSPr1yViePjEogNZvfUvEXGJLveVycqoTtapnajGcpY4F11,true,293322052,293322056,4,1727896598,5290
76,2GmBEQLANdc9gtB7Zj2BMxZKhnF4L9jmbmEc3csPhfhpur4nvrAXQeoW9ZHBotMxzvPGi2jqgdpEVJsoQZghhTN6,true,293322052,293322056,4,1727896598,5309
79,5UJ9ikrDyfLgU4dfAR5TnN1DHih59b827ztq82Cqt8ziAtUsQUWBew1SkWK1mch61Uc2mW5CKz8LHKMEnmJ7rRRA,true,293322052,293322056,4,1727896598,5314
70,5n5LDfythMhbFPpwxn3kDKnFGqr1L4QwdRBXRDv87XahxnMjjS1gRoyz61Hoexpe5k96FoAe9KWfLmkBoez2TkP7,true,293322052,293322056,4,1727896598,5357
78,4GYVnYfQbXAdPNwMzfMLZG2kqg5sKVyPcwNMjj8eSwmYFfJp5U4zjEksFyGHVZx8U3GuonjNThtqjAkDUvN1y4m9,true,293322052,293322056,4,1727896598,5486
75,5Y3Hfa8E3pbHCAmmjpGrRcmuZKvxogHRcTuLsELFSyvbFhGQf9GyKzv3AbFUjh5udCDnGXSVyoo7TX9QA3ZdKV1D,true,293322052,293322056,4,1727896598,5515
84,62aYVAbReMq1vHVJbwtvRxUyWLo1bprkRvPPVMHoFU8yrv91LMFt12HahidSouydpko4Kkz7jWrH5JQ6uz8CpYP1,true,293322074,293322080,6,1727896608,5190
85,2CkpcCsZEZENaasamNT7sBzNJ8V9mfCKxadxh7YxHeXK3CHFYnmeuE1K6ZS4TUVVNgzFukCkR33X8yZVa7ygSRUo,true,293322074,293322080,6,1727896608,5346
83,3vBMBgT5GvofzqS2unxu5K7b8LN3snwyXMpygnpBj6kqrzRwQsPN2X1w9D6s37uU8kXdqF7VSkCJxPXcYG5ESQFc,true,293322074,293322080,6,1727896608,5405
88,37hTSqr9x4qUUaTrpq7ABDc3bpTctRBduWeJLX3nb61Vu8Y9mYezrwxXbAgfEBPWLFHCTzcvcTtUTgEkQwqPAyiU,true,293322074,293322080,6,1727896608,5468
86,4yRPftEn7fjpuqEJBLpjPWN35UpcHc2aNCSbwV4XmYCLs4xu9BSyNJwBTme8FgEA2KEELZrqdAQaQ5KM1c81UySb,true,293322074,293322080,6,1727896608,5734
81,48fgcASHqVh2o3yCqzq1xRihFFN36JKpF7qrBW3XNE2i3QBpwPmvTuRyz1E8bz4FMFKn1Z3DcqT8m2P9LU36TGPD,true,293322074,293322085,11,1727896608,10668
87,5ho8CKhJT2PqoPUtm1p3e1C2CB7TUwDuNuNoxAbj83RGd8dGKvXDKzd5YaeCBbAQynu82GdMc4z8QoGKzZBREeGc,true,293322074,293322085,11,1727896608,10697
82,44CU7zCgnVeY4rmcoq1dPo9m8eZ8iZtN56FXJMTAvEjeP2bumRofnEm5o6K7WTv8MZkVue4UbVfqp4azRQY7dmpF,true,293322074,293322085,11,1727896608,10742
80,4S6PU4n3bDg3zUFKuf4cChjsqAisYciP2fRUBvNtAVLa4uG2mGD4yfv6svaztdyYAnRBuixW699UAtK47q6EUCV4,true,293322074,293322084,10,1727896608,10768
89,3QDTvS9at4cv2USgoTcVo6dRTTfspTsQPboE82TWFWGoy4rvoeFYs1xSmR2bKx9Bk1BF4VJiuxnubhSreVnpCAeU,true,293322074,293322085,11,1727896608,10770
99,5ouQZWismChHgkSeJkKttC1Ltyb9oUpesiR13dVZ5rVhZioCZ7qMTV3P1U12Ny9ncxFVYJd9heLQFWFPt3Zm2wRV,true,293322096,293322104,8,1727896619,5183
90,SNvX8iiQGQ3aBeofeAChj2XqzMd5pD7XWAFkL9TLymxLkNqKqwLaX4QPUu2GUh8aCdQ8ufW9pJFw1tUGko2j7ek,true,293322096,293322104,8,1727896619,5198
95,42NxBZYbYZ253DHRbMMT1G3noGDWabYxpnh3fGTJYs6JCqtDvrmWLagCCQdtHPsT1xVtAxEM71bxztaEgtjr6Kva,true,293322096,293322104,8,1727896619,5203
94,45LEGVExrnHaYUwuhLEtUeUV3ewwxzut5hKQc6FAZcA735KLmJ5eoR6Zht64QvbkGkchpfYpbsYs4QMwXR9DBBQR,true,293322096,293322104,8,1727896619,5205
97,3qUCMGoYpDNPdBChQoBnv6GQxhCKHwLgZ6pUcH6XBUfctQLRJmNTNwtDBfwM4fjpbFhC5JM2jt8aNRuL72Z9xE9B,true,293322096,293322104,8,1727896619,5210
93,2ktGjk8EnHd2ZT8vvPK2mXyicq1Xp6RzaCKi1ZPQq6Ac1YoCL3XY5kKaSHEk45nPWK323pGKDGdy9DU5eujoyi9J,true,293322096,293322104,8,1727896619,5276
96,4QeG6o3u5C23yBLir3XvxjnJKn6hmt9jNr1TaeoBFPXcgmB9odre35Dwc1rZdS3429VSohhvWdAenPpmEwTKaytC,true,293322096,293322104,8,1727896619,5304
98,5CVZ7w3dHB5i4NaX7PEh55vowHNeupN66ujQvpMB9TARMmWxmqisqNq7QUAGGJYZZ4fswxqFXePsrJe4cmnw47SC,true,293322096,293322104,8,1727896619,5352
92,TRGJWRcEJ8AzyrFS2mmEn2GvWbe4aWao4EmwKDV5Zj1CaaqTyEdLCLL8tX1V8pTLHWtqTyH7JEo3dkuuVgBKGEj,true,293322096,293322104,8,1727896619,5425
91,42rScvzuHPFtBEYstVwEpCSmUYYiCnoESdL42Yda2JyjkS5U69oxiWqQCa3JJr4suB4Z5mskZac3LAnEF8Ss11CJ,true,293322096,293322104,8,1727896619,5559
106,4SAiqtohmQ7RRytPTf8huSL8fYra2KZkdwPfxgi9HfkAJNVqtz5xpnLNQBsgkcipMTeKN7ibuAGCEgmpEjBXNctZ,true,293322119,293322136,17,1727896629,10294
103,5YAxY3V9KeVqvTE9wHwaEsastYQvh89R149ujZYHMpgcEL82YT3MW5iWtcHiBiTgsSeeg5PSpzdtHXpVxtdgbpT6,true,293322119,293322136,17,1727896629,10338
101,6nS8WYgNtaeMGTckytc4NEYCE9SKhUKoojnyVGbjaiUEphP6Lf3RXURgnk3DN7HL3qUixGwJfh7Hv58PAwPts8C,true,293322119,293322136,17,1727896629,10401
100,44uwJHHN7czGzQRxnDzLyqydEpXMZadFdvNhAEmESLhzKyLC3fhnWsMvfG6bLVmSytbBF3LksAUAiGufnSfP6oq2,true,293322119,293322136,17,1727896629,10459
107,QDgbEoNeqBohUMEQtqXL5PZASE3NP7Nkjgakbgh5UJ4NJv6mGSoyWdFgX6qTkjdUem4p2ZXJ1DCybNS4DnWNLjg,true,293322119,293322136,17,1727896629,10688
108,3Wp25kwH9D5zk914vH6Mt8cNNsgZ6XjyWNgDmKDk2ZpfVo7pNwv4jPheoX9VMc41hfwNddSGFXDy71HePRnCdJn8,true,293322119,293322152,33,1727896629,15469
116,4whHUSFPiNh8YSebn6LTCGycX1pFFTgAse4b4CnoGVRNAvM4P331d8PLDNE8n6pc81H46RpNVkwtmVSutcriXM1N,true,293322132,293322152,20,1727896639,5200
118,4xs7L2XatVAzLU37NW6broE38SZ4UCpmsn5uW9UZH3R5f8b4Zda1uGLwwtVHbf5ScJdEwrXk9Ca5ccFPttBPpWD8,true,293322132,293322152,20,1727896639,5197
114,2Rp8Nt639xy4WuxzpYjD9w8q8dvQpaxcDgjPyH6HFhDcgVBKYyvtMrjy9mMp5zx9cWzndSrS8F28LtnocQhCf6wt,true,293322132,293322152,20,1727896639,5194
113,2aPrWmkMQuNDn6kfDrk5iJ566UG7qUNXYmCuNJ1j7wLoaCYhUF1Gwcsqpa9E8sa35GNALbaqpupSZ5vDUVoPpr6C,true,293322132,293322152,20,1727896639,5198
112,5tGEs2dRVZ7cyJJyLZJkVmDuSVFi3donoZQqSRbckJWAb7G5pYRXPmgBYREJEt5Hq2iM42C7TQUuHtWQcnYacFVL,true,293322132,293322152,20,1727896639,5215
117,4ZY89RfYS1VBEpNdomrprvk8kH3R5p7iEsEQffb7Y6ZZdcAydR1kbedgiySaiwZxsGq8i6d881QVobCazgXA1Jcc,true,293322132,293322152,20,1727896639,5210
119,4N41T4R3KmbePAnxNoMByd8Sf8uLffA9yrWGXotW5gLWB9rpcFt1i6rDx79x7HMuEySiCsLg12M6nNb916q4qoor,true,293322132,293322152,20,1727896639,5252
115,55RDc4Aq2WUSN8u8YpMnw6rpS2AzkiXoHJEb3eP7KUy2rcK2PzuxmUBGU97piY9r9X35EVL31C3hPdDVQidZG12r,true,293322132,293322152,20,1727896639,5282
102,2VFrzxoZpkrYLJrtGXTFwujpppHgXdUzsPLWkBe339NkdCVA2cH4bAfY4kn3mHEF5eqPy13vtSVcZFhkS2nFzziB,true,293322119,293322146,27,1727896629,15689
105,5aWoJAQYrAZy855ndGXyeXR9ndNnXmtUN5qnySw9Q3dWD8uF1abhWKLL6dANepzymq5zJhy6XTxd1p7zdVEJXaaG,true,293322119,293322152,33,1727896629,15736
110,2Yp1Rua9EAsUg6WA4Hea3ZgWRZ55gLXDmsdoojm6XMLrQy9GdhQMJrhBayXKeQUsK5x6GzmMyzxAi6Z3HnmSExge,true,293322132,293322152,20,1727896639,5476
111,53osmEFxUsuQWyehvmvT4oqCVZ8C4V6v268Sb7rwCXSqhcWEem5eDFwLn6xoAuY1SqbuVsc6qKRhVjn5uKTfT7Ja,true,293322132,293322152,20,1727896639,5517
120,5NY6EYULd3gBcyNTYH4kZehcDL37dPpGWshySooSGAUSipTrMTWo7rq8JTuBRCQbm18XGn4TDKQZnivpyRsjoSLd,true,293322163,293322176,13,1727896650,6632
129,2xc5dWzYAdmawi2gNpKaDp96UA9LrdV4TDVWrszNkiSk6Msjkbmtov3yaPVho6Cq1HY4KtRPrb7GSZiYTXHkMMbx,true,293322164,293322176,12,1727896650,6725
127,fi9w4DDrzHhYybrP9AGhNTh1GVYVL2S36wMXkycJr841xz5t3xggY7VBoG3NUbjijCeFWj1haCHyQ2FTFwLMcaH,true,293322163,293322176,13,1727896650,10305
125,XMivnzmj9hYLvHt1xwSH4KXsscBjGyE7T591wrSgARm67AQDZTL6mJbjvDUViZuwpSX87yBQizggZYg4ESD3TE6,true,293322164,293322176,12,1727896650,10346
128,36myLvJtDwgXzYzwrZeqmXDEM3HRzxGqWEc5p1iViocKkvbrtUB9Dcb91RScgxcguKzrHUGGkZ9reWPZytgh5TYS,true,293322164,293322176,12,1727896650,10353
121,34VLqWZWuKeHAY9NvRYzxBZ5RwDpQ7eKWgEKXuCStyb2ruW4eUj9uAf7MkvLcQXUx8wGaQcBWtqP9uxBvsQFHqxC,true,293322164,293322176,12,1727896650,10423
123,hDuzH4ikdb27bB2kDDSkgvqYwGpuMUP87HNwjoVu5QTh9Jyia49u9cPr6jovjNKaR4jArF1EePUujrHF7fpYPz4,true,293322163,293322176,13,1727896650,10475
124,2xaq7SciKgJNKKGxEKVEEFCVgdnvTZWFQY2hzCei5kBEW1M6kGtSUfr1pggs32Cw6YimLVM3urjmPices8CpWK7H,true,293322164,293322176,12,1727896650,10544
126,4Zn42ry32ZqDE9QK1wSgkgPsnBHimwpF694qManpmSCcdDSgZnRqLbnE9ZHfnhNpWh9jEk9ZeqkQmE4iUZVKWS98,true,293322163,293322176,13,1727896650,10576
122,hA3R5KRosoDZga315kSErDi1At9kaaCmBCu6ELjHCm9NspVz4fmj95pSeVAEoRDZJ5yq19dh28gVDKkj1nJfYoU,true,293322164,293322176,12,1727896650,10633
139,3Ags18DUw6zN2mQBn3sXJmWsYHaKf6vy5ibCh1FacnLcpuZwuNV9ND18YVQ3Jm9Mkw8ds75aAiEeFpFMWcVckVLU,true,293322188,293322196,8,1727896660,5186
130,2Y1GTFkWVh3wC38gsSVTvjqPqhRNjg3CC8hh7nh2F4nBeHuG2WU5EnGpJGMtzXfFjm5zTPjEoSBhcjRukWVMcy1u,true,293322188,293322196,8,1727896660,5193
132,2TdcfkCnPxovP3ktcdKjKv3Gn1Fk5fKv2idN6M6dsdWSA5YXZKiXErsVbNR3VHyomTDEzaxHr1Tzxa4x2cV1p66Q,true,293322188,293322196,8,1727896660,5205
137,4fDtisFyhNDGHCG8T4SXrdFGPXPFdAqRcmjNdtyZbDPzftsBYmBVU8GHihyx6Q9D2kKtJLkoUBSoBZi9nrrxrkoV,true,293322188,293322196,8,1727896660,5209
131,6Ho8g5BGm4WMT8MnEViVqDYM4pfUNdkd6rksKPCVDzdbSvdU2mhog57Avv8gnZDpArKvsVr4GkpEFXKpRN6a2u2,true,293322188,293322196,8,1727896660,5221
133,dvDsZwwYV2KHewZjyMkbnts9SpyW1HBf3nW7x4ciYEP83d9rXQhTFopnMTT4yVUS6EfD1meATs6ubXmC5wUEi6d,true,293322188,293322196,8,1727896660,5210
134,3tamgtAr1oEU7Kq5PzuG6ciEu3F7KtMPY24yEmpw8mSFue16eiekSY2dj7MCFsdtciJvnQbHrRCr8csY7sCc9T7v,true,293322188,293322196,8,1727896660,5212
136,3L8J4cKgaJFszuXcfR1ieNtSoyZV4JuHWsgtomYLizz5QZWBgRPwALQRMkDXkLrb2AfnwoebsFHjEuA8a9RiHBJt,true,293322188,293322196,8,1727896660,5306
138,Revk3qocpTQfLwmxkeFPyaUFURDkJey3uzDCSqyqaRRoojz7dKY8bNzysqC1pViWQ12qpJEnMgDp9L4cb59Uh1h,true,293322188,293322196,8,1727896660,5421
135,U7PKp7pvWFDTtfDA3FJ65Gja1UbLDUYFP9H223v124f6iK41e69vgLR7QFDSFB1vBActV5NyMDzAyYnxMwuyTma,true,293322188,293322196,8,1727896660,5467
147,aY2YaTbigimMdF2eQkBpYcTDFS5iJ4uTR6kbPFLxMj6EYvryQb1p9D8u2W3xFqbL5vZRNarEbxoDQHhTeY55DDS,true,293322215,293322228,13,1727896671,10316
140,kJyZ73q4xGurHzzQdCqDyo9Jq4RaHJDeing52Zxh1YPpkcPK8davRk4bJdB9WyuyG2xEvhhJbvKDWKfN1M3zY3q,true,293322215,293322228,13,1727896671,10323
145,X3QKqvFUt1CB7FUsKnBzxG3xan7Pu3u3crGydLDyZGvKbSEPuMk9E7eMtKjsNNmhYdbuZwgHL8LSsNk1yYh8DsJ,true,293322215,293322228,13,1727896671,10348
144,65aNKSvdZKRGYTBMJFFq4gN7aKTdFWsFaGKA8MXTvNNUUqXT1SHfQhuJSu5MEzgwGoEkctxvA4Johmc5cVMm4vs,true,293322215,293322228,13,1727896671,10355
143,aQQ11ArMpyDFzpuiVgGv9JWwhsFfEbwjPUuseapgcnGVb1g28Ex2sjATAhT9v6E58qP6uK4S2zoezLFA2TqTAb8,true,293322215,293322228,13,1727896671,10353
146,4u2DYn9bM9yiC1aM3nUKrF4JnnZmYvJ9zR4otfik9GrXThyBvx26UmtzMJ5MM4wYWcRLu7Cku11c66sAMrkADK9e,true,293322215,293322228,13,1727896671,10361
141,5F3b1FGWgAHhfatdXiWB1ZdjLCpomNwxbAxtRtbRvqYENKX4KPUuGnkQELtVFBY9UiSeygiNsDbtpLL6BHjoT9fT,true,293322215,293322228,13,1727896671,10406
142,3QjKXG8sS4CwKBw9EBB5u1gEarrGb4u1CZm5jFVJabT4SGTxuFURbGb1miCkMeyHqmQCeSXL2j3ngeXP6zGSrrDQ,true,293322214,293322228,14,1727896671,10438
149,26FXGAepQcCWND9MNAg6SCN78WYHowkbMXMoui2av9RQ1qoKiayLBzs5wJisGQ3L8kC7EvmehYpwRkm7YazYkUQ6,true,293322215,293322228,13,1727896671,10585
148,3DQJciYBBzim6ZtxyE59YuDcgXanTNhErWtT7FNcxNyBroH461dHPjVN85cDD2Ts16AesPx7BZhHYdakgS5gphFv,true,293322215,293322228,13,1727896671,10586
155,2pXTWijX6dMDSdbQ8usk1BGF1uBTBXmDewGKAKdaZBmN67ZBSMzrVU3wzfUANTYQzWspsn92EJSLe1GL6QHkaa2D,true,293322239,293322251,12,1727896682,5143
156,5PKsH6dDidouZ3DDQdoPeZze7knEoA7uW3GZC9Ps4ugo9eh3F9zPuMJ6EYJ92BAfBNaFt1LkSpG8hrRdonoagxPe,true,293322239,293322251,12,1727896682,5195
151,35b2iFcjkTp87k1QeCBnL8nmPeYaJAUKCqEmivPCbPDv5TDjAfJZzQ4Sgt7osTojJ72NbDYqkk83MtxpTfhmDF9V,true,293322239,293322251,12,1727896682,5235
153,4a7Zh231i44t4tLheyL9BVu25DtDyd3Uyx6RoRPAzHSak6aUGrtD8c5nPVD6r8E5bMnYngRmDe2kCoayWPJRntMs,true,293322239,293322244,5,1727896682,5236
152,58W1tpC6ZrYfzs69W6RvN4iNeGFF43Cjz41BzY5k1XHDEiZeG72vUHDDu85vs7pwp6TcSwbLWrs7u7cbmjg9We4z,true,293322239,293322251,12,1727896682,5262
159,3x9uwuA2MTUyP5PMLge9Fv4f9xy1AvQkgxGrmsQ7dTAnz5mpCZoSrGEfQU5ty49Qe5tsWtdEx5avENM6AM1A2qTj,true,293322239,293322251,12,1727896682,5287
158,43LhKsJEj4ENVzKA2a6DgmC86yrTqvWLMuhD6AXWkrTGAoqidpJRLBQZuQZSUVD69ZiSaqaqT1C54FsYovkqgb5U,true,293322239,293322251,12,1727896682,5338
150,36n6eHuhU8TKtsw9awRbyvqYvPosz9ayL13e1yEqVLCAbN7RNzCDSgV1rTfq89JppY3ksxUd5pbvtPELHzDJPiEB,true,293322239,293322251,12,1727896682,5573
154,634Kr2icktKSaKSzZhMXhwfsa7KPjzj2EteX8vNQrWsMVkAbvdC1CYn5G4p9NEvE6Ped6W8LhxXCzj2yrdYaQSTW,true,293322239,293322251,12,1727896682,5587
157,2QeX32tUw1AjSHp4xgGQ3ZG5vTptxrPhC6wtQ5d9M2QdvrxgSpXZoGcDzZgNYRQXwt36Wwt32tMtVzu5jJg8VhXr,true,293322239,293322251,12,1727896682,5637
