id,txn_id,status,get_slot,landed_slot,slot_delta,time_at_txn_sent,time_taken_processed
<<<<<<< HEAD
2,uwFSRDYdwqyftvYmBqSDoBvvmfoRAM4FQvvQAdQXmzr5pheF9NiVonVTQsMgL5GuPGSmtadcJJAFWyygYMRyscB,true,293321891,293321896,5,1727896524,5496
4,2ywjHEeHFEnkz8bcwnXx7fPsogj5sqB5Eh5np6Y4UUURA6UQYeL5TAWRHeJTymv1UXhzAAXvXpbkKWfGRAhp16r5,true,293321891,293321896,5,1727896524,5503
6,cbiTLgddFhcqqzPrkZTPNGrTy41JSjYHuC7x1AnqfvLurgsZ4naXvybH4JEoX8XdhtYYjT4L7iH7vat6DxV4HCk,true,293321891,293321896,5,1727896524,5504
3,42KAQRNCFeZdFEG1EeYB1QyAqJbcNCFEGHxgdAkopS2JUHJ4JbrCbCaWpCWRQYytMmEyjrNn4XYpVJkF5BVSBM1H,true,293321891,293321896,5,1727896524,5515
1,5mmTApmVLXt2tH8NQ2pRfotGcDtVB5ozedo7aAaVr7tfhyaLvUz5ySh73RY16kGcd7uAGDYV6Ch2yDaM5K1Cbd7Z,true,293321891,293321896,5,1727896524,5547
7,3VUdQ1yckeq2ZsQtJXcQagU2Fza3C3e49KGf59U2caiT6qCAspxLbxnA19yTkjHD6Y5KuDZEUavoud3aJq3iKhwE,true,293321891,293321896,5,1727896524,5573
8,3WUE5uaupdpxDJ8otwkQZpQeQwpKspPkADtT4LTwB77jUCSQjpL6b5A3RfdHrjQvQ2inXoo12gzMS4VPqa7hM49i,true,293321891,293321896,5,1727896524,5578
0,5etWTq1HKrFbggJGKGbTuk7opnUzJRAq2FZBekEpqxj8M8e7eYd7ALcoBvPSaF9spHxZwj5ekGPE5ia7CpyfwoGS,true,293321891,293321896,5,1727896524,5605
5,49crDGEmBmCmuWTEDg7DTYaBYJ3JzSLNjYDxnn3DhHkt7uZ2N3KCXkmdYBxa3eSRY5qDX92sUFULXWpGbDAbAVqE,true,293321891,293321896,5,1727896524,5652
9,BpU1khJEWicae4YXEjBsuRCemCLCSZ3RShD8xsoawq4W4Gu57rgRE2q46iiCm1S5sZh28ZJR3BN19SFGtjbvEQG,true,293321891,293321896,5,1727896524,5667
16,5Z2zfLNiKNe1CEo1fK23DkMuPvmGQcCQdBQj7qXAgN2fBRMtcoVn4sad8ZpbWqVdsYkNFfgg13cEoLsCJULw42TF,true,293321914,293321916,2,1727896534,5167
12,2FGo7XnJwvFA1AqChj7GDCMDzRfeXzh6RNyNVeA2gPt1mG6CY2gWvwPuRepasFV73WJrgrRsv43dUMn5kAYMmkb9,true,293321914,293321916,2,1727896534,5362
11,2dBQz9KFpsAjXXYuyPdJwNHhPh8MC8w84WKSmmHnNBDuQHAno895gvn5Qrc7ADcB9xRcptmv2wxRKD2bXD3q9WBm,true,293321914,293321916,2,1727896535,5416
17,4YRYZszaPjtsbGQg7T2cVWHqR3wDNcXHLoDUeuijTkmvbJ8KpPaMgvMN1Y6qNTpk4SXB2eK9eVZN1VsK6Dspq5Uo,true,293321914,293321916,2,1727896535,5437
15,4DqbduaM2aFM1rJCsUDWjv5Wz6uDRRKCkFvjJjJWQ3K8Khqxh2DD7fkshcSMw2Cyjs1syPpMqgcgVt2rKj37GX74,true,293321914,293321916,2,1727896535,5445
18,24u6XsfoGaa8HLTpCJRGfiZ9EkGqmdhn9AyiBXpcwTvYahT6hi2hBE6pK5t7gJidX7rTvzNgweAbhxPsoJEuBkpc,true,293321914,293321916,2,1727896535,5465
13,4p1wWKoPD83gYcfvyohQgoiHmy27DvqahVLo7PhWgMjXiJpZmaAtSrQEG8WoQyEnnG6btE2msbrJngV4NxzDBLvh,true,293321914,293321916,2,1727896535,5476
19,37LHWR4TtwcyuoYXY7kamBch4aY3RkW8HL7QPTtHbwctkdLhrADAvbmS4Zpn5UhD5sJNv4WxYr91d3iXoQBFZiBa,true,293321914,293321916,2,1727896535,5503
14,3S9oL4cKQ3AhLbQR3gutvaGcCoQi7hNF5V25kATC45GSav6LKHBKWMWAE6K5AnBCdK8bNxs9185QmqRocJb99fXd,true,293321914,293321916,2,1727896535,5491
10,15qhidoeoAp9W3ptThPQ7Bb8dGquv3z3oHn9r41NteGt3yQgzkm63CNrzM8epTye4kKPqPVcc8PnMgFPmuXTRrQ,true,293321914,293321916,2,1727896535,5540
22,43ErcaE9U8VTexJZdHPK6gnYBfQ9T9E2GhiT3QfrMXseyh4BrVTzGD4eSug7YNe844cr8g3fvGU5FjVycTEDWrSF,true,293321932,293321940,8,1727896545,5185
25,3gQD9k83wTFkaVFTPNudLn4EV1AfruZfAsHP7sn2X4PsJQ5Ubte6kBbTaz3iURisznZBMSYybV16p8bmWWEnzjaN,true,293321932,293321940,8,1727896545,5209
21,56WcZa1YXmSiBZ1qRTPLSfixegx9ijt2VEnigKTsZaGx1LrwFjDceWcSDw4GBEuLVyVKCpoJesaASkCjvzaTg4M2,true,293321932,293321940,8,1727896545,5242
24,3miMJehASGR5RfLjiLAtH1am4SX5gZXHFRG4JgxcfMSur9RwGQ5kyBZiKm6qd35gLPoyXXAzoSeAYH7DYDut2nFs,true,293321932,293321940,8,1727896545,5427
26,5gRpFbGHpEEs1v2kRwPR6NgsrERZuZLyAZEyuvfXcgUdwfbgFRvghUBJ2hkSK2UiSiU7SVDWGjHkuk2Es2V33UTo,true,293321938,293321940,2,1727896545,5466
23,2rjGq4gWgVSHfwPeijiznG4mSbyfyfXsFz3YoAbuyGqnbZwUq4jqdQb3LqASwLigH4VtU6TDrPEFzSusfyp7jEuU,true,293321932,293321940,8,1727896545,5488
20,ZdXB3HVHFWBhpQktWhhXWcf1H1b8pyGTak6h4cuJ4VkwQwgGFFAuHqE7txDgJezok6UZdT2Nfh35V9ahfWrvyAj,true,293321938,293321940,2,1727896545,5564
29,2zhamkJYmW7V5y7d1U1CXdt1QjfR1d88HrKJNgndpNYdKAMgoPqGegmGJSEs5XhzypJU5Y2GTGBmgWJZPFo3WYN3,true,293321932,293321940,8,1727896545,5530
27,nE6Wqj8MSM1g1iKrGfyn26jhyw1jC2NLdfdq8RgzZQStthYiBqS6vw61m4VTSnUWysQHyYLe2FNZQhDXEwZpCAX,true,293321932,293321940,8,1727896545,5568
28,4M7Uo1Hf6S6kUa8vJH53E2Y5fA9gdwT3ekXMtb7XjNaxPbSDP5GiwhEq5F56oPMoz43vXRLJ2wp7Kbd9qGMxmmUo,true,293321939,293321940,1,1727896545,5548
36,5T2rLrP7X2BYKnai2ZwULnoWawQGhX7hHChae86zoFkFrbnKeC1e8FPjFyLZaE7MXj1DDq1oq7V9s67U3gj6afvq,true,293321959,293321962,3,1727896556,5202
30,3RZbe2mDdbt3GWkn6A9MSPfj2wMFQ2efgqWR1JnGLqDHuQF23AXYn8Vk7NQvyEb9Wr1cgsTChb5BHbfC4iK1kwfM,true,293321959,293321962,3,1727896556,5309
37,3SwbnV47LQwbxbn5HpJ7zcSUsygN2XK4Ku6QATMYsUHekdf7QcGfwTVQVAqy9sfJCyErhPomVXbGD9mvRmMM4LEz,true,293321959,293321962,3,1727896556,5310
32,5RdCVuffxW8DccwJQhUxUfSbGuEsKPZHkZEqUmKCJzNnKccRAs1buVdvAVT5LR7N8weTAzALFZN2JhwNgim8gokB,true,293321959,293321964,5,1727896556,5476
34,3JHS6EKLHA25QWVSGG6iL71Pg3WArFuo6iz9Sp7VqdVDJJt2eQj6NaStkDz68LtJYDyQpCFStiUrx72mBHnzssxF,true,293321959,293321961,2,1727896556,5507
35,4p74eSABGzVBiTxtm3CzFpUNjxvnCDWanvxoPb1bYvxYiYDKb4FaRrx3UojeQQ6Gf6w3cf6Lk1TWyrMqgGSA5Lrp,true,293321959,293321963,4,1727896556,5533
33,21tXtTPWDmG9oiPcvgNzxz3E23BDfhnJqq7ktL8fDGvBNVUH1sDqS5GykhS9arb9zXKQBNKCQPFWdXVojwdYaXpF,true,293321959,293321961,2,1727896556,5555
39,67jYtisf13MdQWbMeZFvtPdFkaRaztuc1PR5FimDaQhheosZp4wJHZXTziBMP3f5x9zPZ85u7EQr3KkHeFzX2Cg3,true,293321959,293321963,4,1727896556,5563
38,xhaXSzh7TzYQApQj6j7AJJc3245hFzT5cynwMhdLgTTLmwgJN5nhyNBhv5pggEqtLFidRSChWL1gqjeYb7W8XF4,true,293321959,293321962,3,1727896556,5462
31,2aYcmJjLNHmV8La1upqcpwmWwgtvfU1Xuf3hmysrGAjFgTxH88xkgZmjTpzPF9hEPTBtGb9bfoa74DqyUegP2mPp,true,293321959,293321962,3,1727896556,5558
45,5ULJtTTigYWPjXojnnP6C22JT7uxKeCaUCPH7QvzCMojhEBYfxL6Y2XyzmssbLWtgHp7vCpg6UejWyDj42x9TrVM,true,293321985,293321988,3,1727896566,5197
44,2gd8vtJhEt2hrfwHEoiV79Trud2V6AmyAdevyeekSnXeTw3n3vYaaiAR15Eu794XB8DrqxFodcrpUUcNcXvuyaZ8,true,293321985,293321988,3,1727896566,5212
46,2MrML1PifUixa1XdL1vNjYgDZuJgrpyKBf28GyjnEDJYCeeQg4fdsmC8h9ymMYsF8H81vH4E6MtaceAQ7DXAQ9P4,true,293321985,293321988,3,1727896566,5266
49,5TPXMfY6WpGkSzgoCGd8pk6DSz3moyYq1SganRHEPdzsfab9tFrUD83amRojxnshmVstz9GwXbPXEE51UTgvtCNP,true,293321985,293321988,3,1727896566,5256
40,CMBMnPJfu5dqFiWK7ft8f1TtpaZ8seCBvem7BuD4pkcCBWktStNjwkiaiCaZTTiKjkQSfjfjzddJbRvu3gFgkU3,true,293321985,293321988,3,1727896566,5279
48,5gGZjmLL7FHwrLAC4B9RrMX3KvkM1QSDwyWVb97Tnt3bHd7JbDBntoYorhf4a4oWT3sE9FEVZxpKj2RbMFBrDswK,true,293321985,293321988,3,1727896566,5436
47,hWrZkWDUSN31MP9fSgX8Qd5my1ULYiuMWrxTWKqa6mvaMi3x8BdjRtvuhD7W3BYH1AF33RhaY1aetKx8Wg7ReVu,true,293321985,293321988,3,1727896566,5485
42,42u5viYsY4J5QdgpjeeoNSqJoti9PXjkNQ8QwRhJioHtejCJLerLrzEw8vci7D1xGyyX86Z1R9FrXw2v2e9yrG11,true,293321985,293321988,3,1727896566,5514
41,5uPHrSeF6zqHHGuSV1SC5f9SHGF8UXSmQD2vdvKBAVw9cGWRuEHj5zBBopMaoX2pnBUGYVma7o9F3o6ZPj9AH17Q,true,293321985,293321988,3,1727896566,5534
43,5Ma9Yqb1pTtViTsPykbt7SGUBKaALYbZqe8QoXXjkX5D4CevMGzugbpsNusJxDS8bh7X64euiqzWkULf4cq8QckL,true,293321985,293321988,3,1727896566,5541
56,3yXQVzrVsRsPbWyCt9KXi62vivYKK3xZCeMCAxf9gmB1tERTj1U846sCSxeUPajnmSFi8Utxt1PGUmUNzwJhWthc,true,293322003,293322008,5,1727896577,5177
54,64agbz5XWQdfzie4ZFhgsXgeBbxKXzE875ANEwtxLn42sooTwXqA93NA2gSEEkNcJvUv3HLywJwRxT6ZY2x5DE55,true,293322003,293322008,5,1727896577,5184
55,2MQpgxbvSbhHHJes4jkBuMYXmhjSemdRQ3C54U6dBbWkLYq7icXLYcBNYmUpc4U9Z2cjRXzyzohd83iTs4P9KvDA,true,293322003,293322008,5,1727896577,5199
50,3aGKBCmxDNjGdAQRcSVVs8y2yMnVFckYf81UEpRDL6tFS5H9H2VDegZTqtFmwsroTABM1LvZm9ubfxFB4VHGLUSr,true,293322003,293322007,4,1727896577,5442
57,3rt3HPvBKixMigqsgDeE6LaZiJgiMvrrMiRJCxLEUNmz6fgmMRC4VG3wxDG61k8CiQRu2Fd2maXxKgP43bUZS3Lq,true,293322003,293322008,5,1727896577,5425
51,4dwzJr1eTsY3h19uUsJZ3ndfAzBUapVtrmMfbmesyJWfag4gNJtdMFxvpwQvajAs1bPk7ykM68DHN4NsJugAYQso,true,293322003,293322008,5,1727896577,5431
52,pYDbDoYmqumkUf7go9TZx26TwChBoJzUjvtvRWaDNPAXQV3i9qhSGGvySTza16XubHqYysZ9vbZ8aQnS28G7Htv,true,293322003,293322008,5,1727896577,5493
59,2pTCjT9iBsDMQ8fAUnhAUpkmFyWkuzqYDKCuDmd6qBDCcRJNxrQfVUVWc2VGVzxWSWwdcR2X5ZYwT8JsuCTuaZve,true,293322003,293322008,5,1727896577,5498
58,2GNNWTEXpmTTD6a8Pny7hKYJXxDujrQGdFbhXhhmMMFjttdQo1m7Q3v5tT7Hf6sKUN8RN18BLvWYKtyz1qgt2ZNM,true,293322003,293322008,5,1727896577,5519
53,2FohfBRRyMGRv8ZXWCaVqGsix3GG1dnzbptPVtSzyAuj7hSRjf4YEUepgZ9J8t77wfYNhMFTNpRpjUhh4wczfgd8,true,293322003,293322008,5,1727896577,5571
69,5YxnfLS5zqZRDEbLLyfTuXcPrPRZ5oLqEN9YykGRPkqJn6wNuFbHda67wnzodxnzNHchkyPETTY3vZ1Cr9tR9vx2,true,293322029,293322033,4,1727896587,5205
63,5kKiUQqrubMykZnkAemofExY87KSTD9jFiyy5g6K9tRqNKjd3QUj66LtzubcTKb5nswNNzGuW9mpXMVr2XxGVi3R,true,293322029,293322033,4,1727896587,5263
66,4UGfpBByvnPAwVUKxY3ti2tFkfNNzyVdG81J9eDSYqdVDXx45bmYAruxakdtgd7DXCV7ANBP1Jaf42QbywgDZssF,true,293322029,293322033,4,1727896587,5302
68,5UBu8NPQwrFv4fvZxd1YAkZZzbF99Ek3NAHpLyT2GzUV8HU8he88gS8UN7RfpeBcaDqrEvdvSaJ4q2Ny8CuKxHKy,true,293322029,293322032,3,1727896587,5300
61,4ig5SYHtmF3imvtSPjdzWK2Bdjwy34KPD3Ck6rJsawNAaudkeAHXbkjReQY25Lt45RU5ikuXRVGpNgqBn72qEZgC,true,293322029,293322034,5,1727896587,5404
67,2cw6SowEZWnauFtR6SXXtFg6T57zTKriauhye1ZAsZ6Ta9cTSrRTJyLWp6eEZ5P1ZdHoBfk6aVk7AGrYkKjEVNjR,true,293322029,293322033,4,1727896587,5436
65,3S8XWqFpdo1gHT9j5QGZteyXdYyHk9Z5tRLVkvzgXxMPm4gxWFapY94TYJKwsmoyaKKGknnT4RDtBZtD8MsKEm5G,true,293322029,293322032,3,1727896587,5443
62,4o24SPZmhnYiBR1syD3yajYyDknnDoDqGNbkX6dxFaeiLGi82G69bucr1YbrA9Cs59oj8PphyyD1kGKR63vSuf9A,true,293322029,293322033,4,1727896587,5445
60,46qYxpsAn454ecVr4kraehWF1QwcHVw8yvvxefKG7d59yojndHRm5dGy9s8vcVGURmXYAEJ46MdqapBfKMNJawYJ,true,293322029,293322032,3,1727896587,5414
64,4xMt67Y3WzGNjekmsaBs2t3uEsgxTBgwom78itzCcnxUYWLB7rvfa4JeV8oxwMAkPPwsqgxHYufG7LWL3JCenc3v,true,293322029,293322032,3,1727896587,5638
72,3hqnnEbz9cA49bWi7Ei5fDL6grkRro8wpzwqyoLXvgtThFCdsSQU3YBtGpuWFpMnojckBY4B88zMfzL32QcCm5pc,true,293322051,293322055,4,1727896598,5173
75,3o4ffbuoiKeFZA2Ho2QuhrB1cqFfoHfzNX3ioyjzPNhcVENUdWmx42fxoFMTjoe14Tg57re92y7FP4GfHB7L9JNp,true,293322051,293322055,4,1727896598,5186
76,51yc9HEBFgoyqvNXQijEsxE36m42GCYumk5m3LgzUDCHiPPUCBYDYjMqLy18NSmspZGfhMfgLGsdVYSvBAtArzRx,true,293322051,293322055,4,1727896598,5273
70,24HRTTBWDyzYLdFGzsfpedFz46GQapVSqGQW6hdkRN8L6Qjpbnh84xNThkzv6UENES1Tgtj9stUtpyR88Jecc3UT,true,293322051,293322055,4,1727896598,5264
77,5D4pwLGJAYjSPEzfJjQghSH311AKD7cRxvsCKAmaZzB1RtC9yPo9i9DMZZY3s7MKAncXgfbWmhPAj9v5wg5NbSf2,true,293322051,293322055,4,1727896598,5284
79,63rSL1vDZjAJqnRagYUHYWGn94RZa1rSmjs6QLbQBzcmYBFyQH1rkzKM3FtaPdmdJLppprApY8kgHyMEnf3bgAQU,true,293322051,293322055,4,1727896598,5276
73,7J6omySMmch4BAwfMY7XEPnsYtR3eoLBf6QY4DFte4qvALqhcg2yLKM4RqJbh8PQaVDtc1iHzYu8DDKx8YkAP1w,true,293322051,293322055,4,1727896598,5420
71,HRHuRhEc2z1jkkCHwyoEx3eqWcpXSwGV3Z7wYD7BC4aqSPQ2disMk5ZX4XaGeN2fjtuK1nPQRwe92QA9toD9ert,true,293322051,293322055,4,1727896598,5467
74,2Cg3nzwVjthn9CUA6gZPUayTkRXhEffYyrkh7csPG1FWSSn35S7wHYJEMt2pGdYhhtSY364tCJzkQ1xS5NazFXPz,true,293322051,293322055,4,1727896598,5489
78,5eB3ZttQoPgiKWxvyZM4Qsx3WiCxmAUHUjH1m1cKcrLrCXkM6uroueuHitDmRVqJ99hg8VCLZdVQMN937cLX3TM7,true,293322051,293322055,4,1727896598,5500
83,3bDCHbLM63kd4nCmvov2g6ZaroeghVXfu5dM3eDcGxuDg6qsFsQgq9nqBe1QkBWtEdbtGcKqj5k5RKtD7NbXSN4P,true,293322073,293322076,3,1727896608,5170
85,3DdpmeMNazcmPcseXweZXQ98mTchQyP9816HoBTHEFJzCJa13f2ouT2PjLmRfHKS1bFpoz7j53GPLcs48FgKCVyj,true,293322073,293322077,4,1727896608,5214
81,2PoG6RS3faNZbXG1tagTSWMtURJxRGYCkcc3R47iqFMuzG5LQNeY7Zc7pEjWe9cVgbYsQmb9khyojT1c4CFY5gXn,true,293322074,293322078,4,1727896608,5217
86,2SPFRQ5qYCKxkkkA8qBWgD8vbmz8Jq7iqJwUK6HVkVEpCo1rywLMYoA37Q1H899KeAKEH8XHt7N64CaJoCiPdR6e,true,293322074,293322078,4,1727896608,5345
88,558D3FxFRiJxk87RwgUPGJHNBRVRtvLm5AfmnHhFLcva9RFt5sDzjEKBojh7AsymsPqHvqZ9fY19uPUWyNNaBrKH,true,293322074,293322078,4,1727896608,5318
87,5heaQwDLJtyAJb1cXwaYHtxD5ukxzsQmDmPdFp5TZpoxbYE6XHZ3fnysoBFuw9woF3Uzzv25fueCA1AzPhui3hJs,true,293322073,293322079,6,1727896608,5493
82,2RVbXmjN8we6tWBWFSGc5BzT3Ywhyag2gLDdpX6zbNHuQfZDawsUE9UCRngJwmvQFUYSXGsSGsHKf6N4NSKC9PcQ,true,293322073,293322079,6,1727896608,5489
80,3TE6jjc7zSn9e7yEvncZxuW2jWUKAwUszp6qwdSJMm5vh8u6m6wVi2eHGUKPe99aQtibHCvF6BDXDF3ugDGTKqky,true,293322073,293322078,5,1727896608,5531
89,3YskjoScP7mTdQPXmYrQnPj1M4JTMdKc2exKq1d9Xz8XShkDbmPq7FSqTjG3XrAjCo1UXeA3bgi6SCqCpvyWimgA,true,293322073,293322077,4,1727896608,5593
84,3UXGjPCy1TvyHRnCCbCw7rqW76xjYMe8rpLKEy1PdYyViLXqnKLwJ5aWJHqjw3DbqyeyWhkvTNVGfpHkT8jajMjG,true,293322073,293322078,5,1727896608,5659
96,4SXAGzN2CYtX8TpjxKvN7vvekqds8fm1Rk4D71quvuEhzxtm2MMsgHYKZmtRuPH5Vbr5FLxBdvH3xsZn8N9HUoop,true,293322096,293322104,8,1727896619,5193
98,51Go7Pd7oBT1KB2JnAY5zVHb8zFmvcp3YtX6bQvC9d4eCBtFKXV9qVHDfjStJrbejqMCgDoQmmxXvU1oMxX2xeHF,true,293322096,293322104,8,1727896619,5203
93,3tVhKR2BYtLDegZYAHMGHcBhhdYqtgF4BWCz93uJPg42z2crovzpiixdvZFAiSseQRnPLfYgdHaHMfwrpTV1wQDV,true,293322096,293322104,8,1727896619,5205
94,Fo9PvHSs2D2Y9QJB1avwjfudHE5SXNDkt2QNWwVM4JM6NGot5966DM41BWNEmvU81EzzFa57pL2BZFiUEk68skv,true,293322096,293322104,8,1727896619,5272
97,4Hvoei9jQMroQsovzgLiyYZAQgoUJQJ54YQYnjrHEjyXixn78GmTdr3bHfGpWdT5UdTD96E21HS6ZKZf5gNVjY7X,true,293322096,293322104,8,1727896619,5290
91,BwRFQAy85dvZCpf2GxUv33oKMGhTN3pbDAUYeUzUvo7KAHBz5WhSYKwBXcxeFF5AKmb7fMD3QAFRfTdYVsV6uBf,true,293322096,293322104,8,1727896619,5453
95,2F59KVPzhAAA5z7zkgm88izq6NQJxDHmw9trKD8J6qPcDK2HwLeP5pQ5y5WNFefaYCEwuv4N888NWC97y2AMnqYL,true,293322096,293322104,8,1727896619,5475
99,V22GKzW9HTT4Pdo11wy6aAJFRqpTAHzsPA2jNSvpmhZdx5G7oay7LoPdEJcyPPS3NHGV3kSbWP43zzYH8kKXsRY,true,293322096,293322104,8,1727896619,5508
90,5hpANBQZDJSqzpLepadJ3qmqxqeUHfz8wir9X3xN6sQpAvKVyBA4kP9KcnscfMYHGCTc2zQaoueW4J5jAbyXNCs2,true,293322096,293322104,8,1727896619,5545
92,4twCR9Y4fpMmD2HRhvXW3dMAjVtSkr9BwL2TU1orPDPzwCENfrvPpyg24hUXFzp8EPpCyKX1CiQ8yiKgmsf1UUbN,true,293322096,293322104,8,1727896619,5574
100,nHVfQGJAUqTzkPYAjH2oof6qqs4RfXUCQ3xyxHSZWDfYyQ4rGia6NzcYGi3nqLPhQJ2u2xJvyT2q4tKLi5LBnCt,true,293322119,293322124,5,1727896629,5189
101,hHfT3qS3tTMk9j2tppnYVDJfaPetWGthriXBZoUc5fp5kGFDs3BCxzSKuZMwVHgvTSVUANbkRfAPQoh79nNZXdt,true,293322119,293322125,6,1727896629,5194
102,64uHtap7rwDqjx3x1mkdMa1ky9WHWUpNWHTvT2hfVPQqaD4jpmTFQ6Aetm1qz14BcXyFsXPFp1fMac1RJWi1Lfrw,true,293322119,293322124,5,1727896629,5205
106,4FfQUrvGwJzypgEKU7iftrfJswth1StygQ9PNb5zH9TKxsFygu3bA7w2oGDXg6Wobeopa2TQbEPzccMmSiaeBmML,true,293322119,293322124,5,1727896629,5205
107,381TZtLsau8JWSUQ8jj2cK3oDEHh1UyPj41NSdxUAcPp9njqtqPTYqWnos7ewKw9gYA99RcebE6GKZ6bP6uYPyJv,true,293322119,293322125,6,1727896629,5207
104,52orAPY2QUdbXPKggReDsHVn3hQTeq3YtBhTxKY6KkkVNuNaS668nwmk1J7k4e5DPgD4BuaRB3KznYZA591Jy7dy,true,293322119,293322124,5,1727896629,5186
105,2g1sEjdRMk25FNAYqZCaGfaCrmwCiUvPzfWYhLc8rdNGxL7i9UHUiEcscD7dp2UEg415dG16whdfnzrn8Lqva9rS,true,293322119,293322124,5,1727896629,5272
108,2iTmFweo7L2MBvvqCPcvyVF1WTDNp3KiFkHicpJbQgco7N1AiaMeRHx5NMfZp5fLTaE54kpK91M9dtRxft8HP8RG,true,293322119,293322126,7,1727896629,5435
103,3LpkUCoq2b5DoBGQaY5rKDFDgVMS9VbEifeAbR1vyQQguwBb15Khs89pzP5T7K3jQBfiAAFgcspzCsTWXoKF8sQJ,true,293322119,293322125,6,1727896629,5538
109,2jx1ATr8EtRgwoQqVXUgMgE9whFYCWY9xFPzYQCzyua8YQnowtu6VgWGeM3KuJtES2ecKqqKa9vfsTPdxy42nZgz,true,293322119,293322124,5,1727896629,5630
110,kgbd3rBj1GEkQWR1RFYPrcppiUuCN1fqPjwy1qGcQWEoTGrrn9uvxBjtWnMs5FyECVKpEJJTi3TNBuZbMrp6zxq,true,293322132,293322144,12,1727896639,5186
115,5pp7LjiNa4F2PFqiSGsYfbQYVeQNUcKvfB3HRU4XEuWamh9mjbz1wRcQkxBWWQFhgNiibyvgTvJseorN2JpwMJ14,true,293322132,293322144,12,1727896639,5187
114,48TdS4NeaGcP5BzcvFydvF3LWWMaw66Xbzst1oWTbPaPvQKv32PEUebetWhabvKv1tDY2wecwXwbf9pydbM632Ki,true,293322132,293322146,14,1727896639,5209
116,494YuLnPJGVGhqJaa7DAF85oAEBxaL5tm8FEMd4J3X6Kv883mHtb78VhxeSfRFXe37e4wqVrRR77ZAUywzMrEX9f,true,293322132,293322144,12,1727896639,5209
117,4qyfjQ3dgpWdVqgWjYFwBr2xYBP4gVJTYP9QYviWX3dVqhoh6mbHCqGzbzBCocNZw5cee4cJ6xjEofby5K3ZHqXu,true,293322132,293322144,12,1727896639,5199
112,5oX592VcqRchEtVm4MjFuwVW3SNSUQj2NSjCgAi8HSw9Zbg9cFPTWvZ2tDUfLgru9tiqWCpwjVMFCqszFqr7qSzP,true,293322132,293322146,14,1727896639,5189
111,2PbiLLkYMusQ9y2hsUiUX57FTsHh2jWLNqGQVRoCuGNgTWQDQu85DQPtteSscNzDmQr3cufpqH1VKPKw395Jmdeb,true,293322132,293322144,12,1727896639,5285
122,4y4ks6UMSJhvQLBsURTrNEroDjaHJthYGzGTZ23nSTHLgx6LNhWqgMw5ctjxQDYCVy9A8dFfaAnh51HhqASJA18X,true,293322163,293322165,2,1727896650,5201
120,5vK6KWYQiio5x1K66GEvMLm34dTab966pB2JrJLwyfhzAoW4MZzKcrnvdQZhXqUQnrdSYa3uxrKXsvf5CAThn6N5,true,293322163,293322165,2,1727896650,5203
123,2Fozb6Lek8p2fJG6tNHPNUvmze7tcjx7ZSYsNhxgzitnEkBqMHsTkHrKyqQANfvEk7BVJ4R7uTW8KZEmhewsckLK,true,293322163,293322165,2,1727896650,5195
125,2w9jMrDKdeYnWGH3NpJEBpPLr5RfgXTRvxnnihLuJwGzXYTvoWtQvyDpUrKuctZdgwhotH3TVEeibfjWDWqH8igR,true,293322163,293322165,2,1727896650,5202
128,4Z6ZRoneiuUocSfUCQF3QkX5v6RqoiYnXNADM2komemUS6x7YToEZvDXC8mFeoAJeVEomuYc2Q1eBhEKL15tqPYv,true,293322163,293322165,2,1727896650,5227
127,4SniW9Hwnkt1JSAnMEgwb7xAhu7kQ7W8xzW9HP2UbYiHuysrQCKCpJyRyNHWCk3UYspkHghQX2o94JGvyRVtEsdV,true,293322163,293322165,2,1727896650,5273
126,2inZ1Skn9Cj12Xo7up5mDjdBZZeXjAvZqAxgTdPXy6obnbMBHA49JSaVPeWbR4YqarqPjXBg1UgrreicX8aRmSWm,true,293322163,293322165,2,1727896650,5279
121,4kRCRU4KfnrEuUCxJwcfCPZMoVvnW3ggGUeDVn31NmK3NDgVcbb6m8AHpcwbGbDwjkUFbdTFULYZT5VzT6YGXcXC,true,293322163,293322165,2,1727896650,5275
129,iKKxpusqiHT21cyAeJoYSQVDMX4asqyo7ZTBg3gAbezDrMBqxCf6B8875iXUS3QQR2RaLCwzMwFWT2eWY4jNYxo,true,293322163,293322165,2,1727896650,5270
124,53cLn3UPrHiaUz1z6V9V1uWZzX8yKDUj2Q1NiRt3WW6vbZqcUoSDQigci4KhuZECSmo1qcTXEYPmG43QKiCQZzR9,true,293322163,293322165,2,1727896650,6636
119,3oJueArrLPUCQhkdxvMq8mYPCLdJe6ymU27EGNdP7qL2vJXt1g8SyGLepdQrFTxxgEY4F9pYszPkiBVcLGCfkphj,true,293322132,293322176,44,1727896639,20589
113,2GEoUEev9TJonRxNPTs5NJBzmJ36UJYx5AoEbE8L6iomm1S4j3973r1dCsYiRCwXS1aW7gg7xMzoBJtdyzWSxM8K,true,293322132,293322176,44,1727896639,20673
118,2fi4BK9mCJCGnx8xZyJvJjxupvCsQrCNLUJc8b8RL1xptYDHh2pX6w175HaS2nu1mG8cVJr24KSLhgsJZbrXnU6B,true,293322132,293322184,52,1727896639,20739
136,4gExiceNQVNWVD1NipPBFhAqFEHyzi78vPZWF2rpKLyvonP3C5Dk6wsYdTYiMnPLMsXouZdBbjkWXJh6qp7Ddkh6,true,293322188,293322191,3,1727896660,5179
138,4KRCvfd8Buw3isPiPWCU9nXgRhaNhJ5o9VaN6gmceRMTErVGecaqZGrjhSkcqXybYh4DiX1BmFupPwrWpQzT9Wvq,true,293322188,293322192,4,1727896660,5200
135,3cM3YHNzbVL7WXBnjmi5Mpqgm8jNA3qLsRG9nwm5uANem9eHpesqFifLJjbNYf4yRNYkGy6oNzxVabcNRbP5Wj5o,true,293322188,293322191,3,1727896660,5207
139,3bf7hp4QfsWgf85HfRMXHkazhoGb6QdieEz12SFergoUu51DyLUtQWwigXiRaNthJW4PuVLvcTUsEVyqUbTW6uNd,true,293322188,293322192,4,1727896660,5212
132,3aWGRmN1RLTkhz2fXHqDhdTNgo4KSyk2xu3Xvxv63nT5Lscdwe2eNFFp5VjeXsb9aCUyZcSEP1UpB4fb6J16dbRT,true,293322188,293322192,4,1727896660,5203
134,4G5JvCx6zs8qUrcc3vyf8yi4AmBqCNZ4ks5VfSH8KWBQZBWjPmpRBtapYcsU8dUMbRbrQUWBXzeTzz5YB4Zwacbg,true,293322188,293322192,4,1727896660,5206
131,27oCBFqonKqvhTaTdtzbGjzUdu5gctXCTQ4FSLhW9q2GEkG9KRFKdHpQZq87yugcT1BYCgfkgQzmK42h9vvutU8M,true,293322188,293322191,3,1727896660,5277
137,3M6GkL9kbSpVp3rRnBNxbrzQfEjaknFvdPwjS7sX3agYqQEXi2QZXfeLNRru2EBboTNeG85SfW5WhaTYTMqMdhoT,true,293322188,293322192,4,1727896660,5464
130,ZFP1QuqFWALACMtaQwkcw54FNfERAt5dSzafKykrNNd4LyD8o5YVjoVDwbVctYzs2MBh2JxEEKQjH3V7f9AmkmN,true,293322188,293322192,4,1727896660,5559
133,4rJ9sAKjH42AgtG2QNKw9ntR1hF8zwWNs1y2MHzp3R7AJcxU4PqMZfNtPa9CeUtBPJXPbk6gVdejSwpT1XrUHwr4,true,293322188,293322191,3,1727896660,5568
141,AbDZT7bRczbtnFZ4RDESKFdW8oUGwWv8DsJDJWhr9tPbeVuzNMFyMnj7WJPpn3VTsVuZEUYUHC6KJcKhorwVWvC,true,293322214,293322216,2,1727896671,5180
140,3yv9zpj4GWPQCqJijathVqrpuTqo9RygKz6N7JpfpFu1NPdUahVNoXHWKXRdnfvsiG8E9nxuZcfuvubKgnRV7Tc4,true,293322214,293322216,2,1727896671,5178
142,4AQhfTg6Aco3nuNXK8wxQ3Bsjr5Ar9grz3bG5X3VQFFn6UT6JeWNuEmJ9X1kKUbnmb8XpE3dwY2qnCdaRFZZjDri,true,293322214,293322216,2,1727896671,5184
147,59iiivWSLh2GADzfY6KveBjxvWvBRpe4YJx8NQrAKAg9HBfC4WuZaxv7wwqHNqNPSh2qU1NdXzYH6bbCWi16ezYj,true,293322214,293322216,2,1727896671,5182
144,2M4CtvhcxyVAh7wDeVnMjVSJHSEpE3M7S7BfMCPG7ALtxCUbKb4aercEisYpWn145vNzVKSaoCr73DgEV2p7b6Xv,true,293322214,293322216,2,1727896671,5190
146,5JKq6WySAL7qsRhEshm6ivH8f6chGPVneuaaGtHiKLGAL4aEXDsKedS4WoDvrmDS71NX21kGvPCPze6HCzdzziVq,true,293322214,293322216,2,1727896671,5197
143,4qDPB2L7Wte2VHZdx1HXF35uZxgj3TL3Bt4Yi7MhhWTdtPiFZsXxVAk8yj2hD43pmpQigHXRyc9S5oCtNmoRLMa6,true,293322214,293322216,2,1727896671,5202
148,5EgQdLzHCRiSbAV7cuimMEpt5LkxpQw3CFeJbGiFx1RKmrCYGqyNedLwRxjEi6YRwP84ikniu2QzhNcU7GCmY7uu,true,293322214,293322216,2,1727896671,5211
149,SbxYuTpro1ZFkt4kXZmLqpkZ2rMPSJmJz7LsfLvWam5FYBUeNkyo8JTaepmgoiBPG9QKTJkwmEQWj6ujsFti6Bt,true,293322214,293322216,2,1727896671,5206
145,xUyGsZs8JsgwhdXZ5Uyki6rPzqsupuWaaXRo5rho2d7n6tJ8x7Z3Nj8xzJ7AmuYnxwATrafVxZNm3DfJDUZqL3B,true,293322214,293322216,2,1727896671,5298
151,2sGFs9f7CXVm83ibgXLJf32BSMfbccmuGgHsJVBW4TiJPAXw8X6YzMv18rdcroZTCbAAvDhXq3cC3kgVLgp51hj8,true,293322239,293322244,5,1727896682,5173
155,3S93QbRf5G2EcufpcSVBoFFURFqSzXLdzgPCM3gvePN7nycagFrzv5iHQE8VXdVghBU6GTGjg3M8JkabJHdeKrEM,true,293322239,293322244,5,1727896682,5160
157,4a7Zh231i44t4tLheyL9BVu25DtDyd3Uyx6RoRPAzHSak6aUGrtD8c5nPVD6r8E5bMnYngRmDe2kCoayWPJRntMs,true,293322239,293322244,5,1727896682,5190
158,4eLVXyrfJJF8Z6hSwv5tBVaHbqh5wb3jesRD1DbxeiZLpGgr8PUZdsqe2hiYtbQYks9S3UUwTzWL7VSiXY7GrpwM,true,293322239,293322244,5,1727896682,5194
156,UAACSKTTZMBvyVoBLAcZTNs98r1zsAFHpKTqJs68tLVZY574vuGVckMSE2VfSx4bg1q75Mt7cBeBebNkyQNJubi,true,293322239,293322244,5,1727896682,5213
154,4S5onxZFR1jLfcCcsVorkcDd7Qa3XEzTTbhJV8HfgMPKtTs2reuM4nKpsdFEB5wjyWmkEw4mnTnb92GZTRzq2X5Y,true,293322239,293322244,5,1727896682,5284
153,5yEXG5LNoZhHWfsT2Tw92rPMjRoCLeTaQiWJvAAQ4byhLyu42NqnUMc3tXM4ACsc34bbfsAVWb1UjXPBd5yJn4oL,true,293322239,293322244,5,1727896682,5281
159,5im9KwZFPPSEq4oNVHjtB1UtvCipa8x4khXt5o5ujdXHmYr9T4XEEx1sfxY4CoJQgmqqSgaQyGraBnAJGwizGSmB,true,293322239,293322244,5,1727896682,5311
152,2DC46etrFeHHcnQwY5D2Kxx1zPRSE9c7CRHnUnugzyJ1zxN4yG2LWBwRppEuiKcMvZszPMneHJWyYXCAkf6nXA64,true,293322239,293322244,5,1727896682,5381
150,2CV1UniALhuqUqpxxSz8J8PKXPwWGBenNJfS24TeMHao15T2ukEBDXZWxDYeywqLhmkv4GqML7jgwQQvXNM1nLGo,true,293322239,293322244,5,1727896682,5571
=======
7,BtziXeNjKG6Mwdf1QGSbpY2sdDdC4p5zd7AtmUAjNA4ANwFebm47T6PfuvRaYBug3bWiyNGvfiR8EMJWD7pUPGV,true,293304627,293304630,3,1727888574,5288
3,3m6txnoQRQ4oDc5NngtvMczbb3TyTNhF8PhyXhScZfXVj7m2dCsxd698tewgEvSM9GBR27k255X2Y3iXhJtF3nG1,true,293304627,293304628,1,1727888574,5281
1,65Fcj9L95LNLuvXbEEPQmtERCWeuXhEcUkEu3RYL1BJiHkKgeTqfdedZLihKmXYAhYjfi1nHWXaNG81EEsC35TyE,true,293304627,293304630,3,1727888574,5310
6,rq1VhN8We3tk4f8Mg7Ldfz67EPt2NBHuRv43Lq8R6v2V6CCBLf8qmrKCrUhQYUCyRwe3UkccUCiEUR3An7yRx7s,true,293304627,293304628,1,1727888574,5314
8,2wubcqPBHsehfhjp2Q41VDPusdbZgaWtrhcqzvaBkPuytgBgrMRYfbBpUYVYN2mRevK1eDCwLCLSKHqySuQUP7hd,true,293304627,293304631,4,1727888574,5307
4,55dZAjTxhNkRDEf6RMaarSQ22ebMHtS6ReDozN6pLvbrF6mpsHZcMWxG1i4CF9Ne1PLmr1PH2qsFMGezZMxgwLvW,true,293304627,293304628,1,1727888574,5314
9,2KQsbEKVmAgM2ct2xbEhR7BEV7XxFMruL6Vr7puMLwFmheZmskdsRSapNS1FqxJS9iUYDdjAZuKbRZkveBpdJTt,true,293304627,293304628,1,1727888574,5390
5,2dYcKhNW2mDYmkHzs8ZWPLZqgpQYCuMPXWJHfu5ygMC3LPKSco1w7gL6yneMC1xJUsqqddfVhmyJGh8fP3bYHrui,true,293304627,293304628,1,1727888574,5397
2,5wLUJRkruVCtPfYJBRYFGG3gHZqXm8npTHCNxz6yePgt2H6ma6icxXrz6hb9UMWKqBjaWZDYN1NBZKtGMM6Kbyez,true,293304627,293304633,6,1727888574,5442
0,3kiSgf5LXusYQvFuF6kpNzrsNwsX58vYuoyE9XtUG3tvUVFuUcKvoYwA7XZUtUwUVVyTAjtp9PHEjE7vfZqwJyr5,true,293304627,293304628,1,1727888574,5360
14,2nHfNgseSKyVo3PLQyiYkGXHe1vT2wBueEs1nWozkFcKDyLTiScEAYc7ay6yaAfEnAXFQLbM75EU4D7CnoPEMBqJ,true,293304654,293304656,2,1727888586,5422
18,5aCPkmewfKNvL8SpCPV2KyUPtZAwzo88MEJJLz86GMi4i1zdsGMfJEVBrGUjuH9xDmKz7LjVPk2wY1tN2H241igP,true,293304654,293304656,2,1727888586,5640
16,CkocTomJTC8LyaB1MAsBzCSsbjXrPskbXuGMtEB9iuYTzxUx3k3LeDZ7adZJXTuNxxKMo4Fubv8beDyVyhowXea,true,293304654,293304656,2,1727888586,5652
15,5KwvAEb2yWukdXhhQmM5iSjXmUuMCW4FTa2pdYB4y6SWKbQvGwbPFvM4dTndgE9V2uP3vh6Be4T5U4yiqBeNbcba,true,293304654,293304656,2,1727888586,5697
10,2eBz8DkzbgQmSqVPenbE8gJTo2rA3ac5VGQuj7CoLTj4778K6UgPUR6Hw7hPHXZpk71kXMAEMFbXjRbbPeEBjjME,true,293304654,293304656,2,1727888586,5710
17,2vv7UbNKvT6Ctciv3f1dEtHpXw3wbgJSBFX2yAwhpsEXH9YXH9GforQ9L4twjCkPadkBNe86pfiGXMgqynMBTM4S,true,293304654,293304656,2,1727888586,5704
13,5F3WnKTixVVsccdVXvSsr88a6Y2QfygxeGUNbNNfTp9eHQwvx8XCFActVD2D3KNf5LEpRH2vEAC53MZSzKGyhcXp,true,293304654,293304656,2,1727888586,5705
19,4F6nmrdWSGDYBfjeSfsv77rkcksEDnZ5yyLKxXtHmxbBNNjnMFGvaN167ZCLfRfhjP9fFER4qhJw3ZNDfZRvBJyS,true,293304654,293304656,2,1727888586,5776
12,2CcBAQReN7u5SXSNa3RovJKXZduEfc7RQtY9nRyZfZ2g3myuFi65iQNo9J7A6dbpAvPbv65VGHSfLB1QnRUPQsRw,true,293304655,293304656,1,1727888586,5704
11,2WxJB3Gszzioj9ggJK2D2GbooPrTxYaRcpnGEu67wDG5oDkbXhF6VEMd6pEz18ohJMQToYXnyUFAySrxNsEim1GG,true,293304654,293304656,2,1727888586,6684
24,5P9LUUwGWPEMZDbojYfbLA8JYipQFJFBG5qfL5ann7MHrAiCRNFQdZFt81HPMsnJmcFNwXN23Z9EXqyix64YcfjZ,true,293304674,293304676,2,1727888596,5513
20,4RrQ7UizGQtEiYdQEjmk5ruXuV4zA7cfCESnpHh5wwQPTLdyp1gWAL9noFuiG3Kbx3StD8tXUsuBacWsPsJyPtWw,true,293304674,293304676,2,1727888596,5588
29,3o5pyNngPRpWhS45YfQ3oX7zsR9cwjXrZZrQdcNsXmVnKdgNjarNjMiJPmGZqg2s1m3L2jGFKGYg3wGnX4SRXjoX,true,293304674,293304678,4,1727888596,5589
28,3b3uGEoF7JTaEwciFke3AviW6a9BjYBM8sDto9T18uaKhv6QVUmCQgYeLQY5Umjje92rpGmvP5Hnf61b4rPhnUFB,true,293304674,293304677,3,1727888596,5619
26,tRUtFQngiHYwUc3ML99VyuG4SWJm2TzsAmMug9UZA7sVHfnTVZDuhn1vWExXwbgonYEihD8ywgBdPFCCvRfYm9G,true,293304674,293304678,4,1727888596,5653
21,47WusgJihXRn5BpicN16ZkBeBz7pifi8DW21yDeoKC56tJTbwyMVDCrhzLBKtgFqeA8MKEctFLmgQ1yeN9tNufNb,true,293304674,293304679,5,1727888596,5638
23,2sLxretVC1CVTQfSLmZcoiRA9Hf6bweJ9oh23BtNLZtaTpNCDpsv9zYZ57FmfKN8j8GJXKMz43LEeLCMSpoaRtPA,true,293304674,293304678,4,1727888596,5687
25,2T1pX4MJfjMWPDDuQhvqNx1F5p1ENwvQaUfKoteLtsvxVjuJUFn1U77GeHvhyXjymont43VUdQyG1jakLUit3XVM,true,293304674,293304679,5,1727888596,5719
27,2jCZ62Vc2xB5rui71Pi41auTgYLzkub1eCKhjeriCLgkZaffZ16HwBh9XYu8cTTtzzdSo5oaGu74WT5aqQYe6xvP,true,293304674,293304681,7,1727888596,5739
22,4xeEpssJ5roK7KiKz8bEEJmDGDv57RXtKRS5azhYuoUqA3Xs4qsGaH3jznUNQhweXVcUcBzMdXg7BehJpeTwJ9XE,true,293304674,293304677,3,1727888596,6330
35,39jEekWz2ENFtwdVkjw4UBWVRvygq5HXC4iEDC2R91Uodx7QjXMgSkX51dmWZdSUtoS2cCX2DZ5spnphbDKmtfSE,true,293304696,293304700,4,1727888607,5424
30,3ZAdfwsqo16PmFvLyJcuvGkwXj3oyhBokWhAQ3PyZWEnApR9s4zjQWJs1eQ1LdzRtuEi9TF4yjkQVUUDuARHcQ1S,true,293304696,293304698,2,1727888607,5483
38,2Tknby3DuBG8RBzvniZMUAFNQqahN56ShsHGQTuw5e6fTL5DrpHMyWnyKofvUCGLx8j4ifbrsrhkt6rTcmiR33DL,true,293304696,293304698,2,1727888607,5528
34,2oNUem82xbsWogKMmptP6Bzwp71yeFbCcjDgvdX2igkYa7LNMQUtem99odKSLJExjtoJ5s9KHoX5NEhDLERnYwPH,true,293304696,293304698,2,1727888607,5537
32,4bMWFsDqgetAAbvWkXDjSYXhXFWXAHzwc3nXvRB4iHmNGxsz4wMTn4JHd7ySacM32dcwxKW2h73ZJr2r2HeJywzN,true,293304696,293304698,2,1727888607,5615
39,2FvWYn4CCrBbAujxrttVi2tfRqpyVfbpBBgWusdiyWLUhJsoL2zo7QU4kELJyVoXo8JsE41TJ9bXkj3scwqi6141,true,293304696,293304700,4,1727888607,5609
37,5mn81QWPkJytKzgynbqPaHw5cHShsk1XCPV77mrekH7aNhDuRpAeL8egDNYRmo6vYuMg2ThR9Jc5y2uM1nb59PcA,true,293304696,293304698,2,1727888607,6030
33,5W27yEkaTmYDyRYxAWDCKsTQiwKcB1wY8EaRwnDWSwbLH5JW72N1Wi79JFitkwKbm6x1Cq4HhYMm77TvBKWf4CTZ,true,293304697,293304698,1,1727888607,6009
36,4wsUHCrCHgetSEXqpmVwJQGBjvgrkiReD2xiCdGYmX92KkdHfbbkjNioPLLZRSo12uqcr8NPmeUThKvfPpjnduUk,true,293304696,293304698,2,1727888607,6241
31,6YLfmZFGyEqfJFgeLgrc1NBBZKNVwbkwqZ2BhFs8djo1buZ6HFHXmhNgC2dxnAj3ipqtaTZJ3iEvn1wbsXS9V5a,true,293304696,293304698,2,1727888607,6492
47,3gPrNiFu1BmASyxtY7QXYG2VRNZYhbdhE3mEPKFyiUnsX8yqqmJd3Axq3KqjidMkiHYV2ZbKUaYQzUqETYcrsF3Q,true,293304720,293304724,4,1727888618,5332
43,4XNcdpDineSpGhdDJyHx2ou1YeDU9ttGkSpXMP5Xbb69RWn3MCofsWcEGT6R5HeoR5V1MLeYJM4DaS1caHXMbJpm,true,293304720,293304724,4,1727888618,5541
48,5SuBCW93To5GY6sq5Tn9FrRsgkQUkfjUu715ZsoeVo2KtviP3mRte1AY2w8WBAmjHtjxF2cQpi5s6tuYXNB6eUjT,true,293304720,293304724,4,1727888618,5555
44,3Fj78cYF8wmMYAqqus21MuKzLxB92oyhiiY6cZ1QCrgBoCkAWwjQu3sGymuWxRw7qxC2BPPFTfsE2uY8C245DXTt,true,293304720,293304724,4,1727888618,5614
46,JzrRL2QCexBedAcuz9hWjBY7va8nhzx2qmpAPTYbjhCnACYDGJEvJXnFwNbVXAc3MyRJygrM3cJ3a7EoqxzRJTB,true,293304720,293304724,4,1727888618,5601
41,28ezPPhorai5q8C7T9aMwXHypr2nhNUJAZXtP5BT5LF6krgybvf5F5taViMgE6kDUzcXZdbehhKSsZAM3r3SxxWK,true,293304720,293304724,4,1727888618,5636
49,2mSLMDYiQWfEqojMVRwLcnbKDqzSvPViYSrmEC1EeWhS8k9jnkEHXqzwujiiz8QUgZq9vypXsWixkgCSzpC2snHS,true,293304720,293304724,4,1727888618,5749
40,Nn4KGftX6HDEpE7RiJzyXiuY3scC8xcjgtQct64f93zviqBX7274MPEg3hH3jGkYGCyjNfgW8DMB7ZZLtu7TP8b,true,293304720,293304724,4,1727888618,5747
45,2UKjKw447Fvn4uzGYPruzJWTswywnGoNSxyVndjBfVXh98WD8x8MJ4pKQL1ca45z8CGA6w5amjA4gAngypRW2Hgt,true,293304720,293304724,4,1727888618,6357
42,5FJ1ma9NLnuK5FqvuGoYXcYpNcXpjhW8YA7TUQCtmVqTKxraJnFoZY6dzG5tx9tSVaiba6w3vzAtV5WD5iU3zsNW,true,293304720,293304724,4,1727888618,6384
59,45ZNx2pLeWqNp7nJhAr2wS3S9Fn2nndSgRYScmVFv9ntEowHrZcHCxaE4HfoHB4erqn9tXnnAT8axsBF3eJhckd1,true,293304743,293304749,6,1727888629,5429
51,5yRr1t8ASYrRxEAUUwqDxiDxepmbJkc8wawpE3zVSwqiLtKeHunH5HE93pg9JwuG5yKr2sjcidFAC3Ngv57WmZRk,true,293304743,293304750,7,1727888629,5458
58,5KwuatrXLMCcPctVqmfEzsAuALypZV7YEoywVpBoiqrhV8K8GhfgTD261qnCoqSEjYx34Dp6zLTn2vCXxvKirUuu,true,293304743,293304750,7,1727888629,5517
57,4JKyYCuMgRP2qo41trJjE8r62zuNp7nbfnEugQiwyo3sSHuRgA7eoddb8EypWaHHfaAGiFeKaNkrFHGnUPiCQaBw,true,293304743,293304750,7,1727888629,5526
52,EfT7CD5Yaq4u6WYbXEoxgfZpkv2RFJo8CjkCut2uzVMB7NPSqmeEwDmTbbC75eVGVYx79npv1gRiQjUQCujjfpS,true,293304743,293304749,6,1727888629,5655
55,2PfZrrchZKKaw2QoS3a5XWx5XRGDm3F8iybubUmWbfLRrbFzud2J3yAwzr59QgcG865sTD6fPBTSYqpYvJMmwxkQ,true,293304743,293304750,7,1727888629,5692
56,gNE9xUUm1KJ5h6LZnyoqn4c9qbx4v6GWLWh6CH62ZfhmKhjhFeEryp3nsKALKkEvbMAgUiSzqJB9YVAsgiRjRhg,true,293304743,293304750,7,1727888629,5820
50,2YY9eVL3kat3fFQMKnUy7zNcLL2CZj5TwAuG3X9BzcUEMBjazqbetUM1P72ZZnug3LpX7vfH27veJsxZ7nW1kSBj,true,293304743,293304749,6,1727888629,6105
53,4SSWWi23HCm1GZ4Vpq3Arz1rsKK4PVwCDujVyRAdwDuFR78yi8xAjpKbzt6NpYaq1mRYVgKJqwLfBSqzU2WvjnXk,true,293304743,293304749,6,1727888629,6100
54,321Tm8vXY1KfKcyeJDeA7DiraL8AHCW3xsG5GZ8XD1CXvsPMd67dC6HzbJsTFXP3PvyPPtxbwTzL59kYA7vmti2v,true,293304743,293304750,7,1727888629,6087
64,RyKuaxYGUMxnWjEx7dvQAN5YJmiaNYsZZk4Ww7pFHxudCUvyYW1kCzeqZgPF2tzBFdwKBNVDtYgrsyCUeXVoA2P,true,293304772,293304776,4,1727888640,5419
66,3RZ7bPvF2okpPSEyw3FXXXYnhQhpx7diCWb4zZWLJgr6Q7c7uX6uWMu3AG8uhHQnZGtkuKqJE2i32JRhC7ybRq7L,true,293304772,293304776,4,1727888640,5443
65,4yAmT2yqSkqoyfc99N4UdsE9kbhUT1nciqCSFawfqRKFQ3mRNHXst4JvMMTcPhuxUkX3SSE62Uiu6D9pKL1qk3B4,true,293304772,293304776,4,1727888640,5462
63,5nyEvuSCX9qiAmzpuzWpyE1YEu5NJ6238RUCHKJuWuba91AgL2YYCsLhCkHzrvJFu9GU4Ld6vSaTY7gspjFKfqeL,true,293304772,293304776,4,1727888640,5608
69,398TgcfzcsmZbBECxu4SgstTaXwGzWDTXGaQPPNL8qkMKJ3qpBCzJkDKrc7QDNJYsZEXDUTvep1mhsmYHhhSUx7Z,true,293304772,293304776,4,1727888640,5623
60,2fG9nJkd9qpkRiCcmaGqKTzJ4EdLM4i5xJrEzm8E1Za3GrPjRDDxySHdbdNMxEYx5zEVhDdbRsGziaNhXBaJqWw4,true,293304772,293304776,4,1727888640,5792
67,267W4pjo1qAWY3MywF5sWDHqEJEFj5fXbf9NFyShyN1om2znp6PjSXUFP5wtWxCJworBwGWMRssJRVNnxXK9xLJk,true,293304772,293304776,4,1727888640,5966
62,4mQ6V6M9ePRZCaWiRgkqDDgnPAopKANVyp3ZC53VU9Ux4GX4NN17Ny1HwAqkcKx3KL2RNNtFiJt5Rk5mVhfnfMMx,true,293304772,293304776,4,1727888640,5971
68,2u1j8tw3mf8EgFX2ECjXrdR5sXwHayVQvpyrtVMWsWzQg9B8wGy94xr3yiwqzR1fU2TBEAVsxNyW7JtPmdVJhVQE,true,293304772,293304776,4,1727888640,6329
61,23b4FWrFwkyqcd9rryUgbaYUh623fHpVMeeVR2g7AWqKCr2MKzucfbxx8S27aR9QxnLfingppu5sruRgGxnwFrvn,true,293304772,293304776,4,1727888640,10436
76,fsChszfCywtv99xFjHXpo7jyXMfzvR7SefFunGxwr8dYCDbfM8iWZZDWHaWEioyhWGEth45oMZ3FdJjAxMjW8Yc,true,293304797,293304802,5,1727888652,5144
73,9M87aMJ9giM7x6cSk4X8rdKiNtNKNhKdMCB2khjFZ7unV1ZnPwhDNsQumjaTAWim49j7zjFvzcfL6gJtu2ccCMr,true,293304797,293304804,7,1727888652,5188
74,62p7QrsCFLvgxZiMRAnW4Qjb8vzBvNWzJYwdoo9CqHk8vdDgVDU4QuTACZ7DFLuSyq4Air5mrWivR5nFTBi1GZvD,true,293304797,293304801,4,1727888652,5521
72,DPLubmENK46pLMv6VJKbymnddT253YZp9rtZs6VpNHPuWsQ7nGM6LSiTdQNymttZJoczJfm8FmVP7NnEvCUBf4c,true,293304797,293304800,3,1727888652,5584
75,PU7TMvXxoHEpxNsncEKtWEpTZg1SnBNTkJj8EawVjEZmG2AW2siPmTWiWvYvoWVQEh8PgHM5ujuGtMkw6kDkCuW,true,293304797,293304800,3,1727888652,5829
71,2DRzMWjyM6Tqj8iKU33oisoLmQwR8D4veR2X11EoNHCFpDFLByynkwpWg2Ha27VXZekjmq9sdbjwCya1uxA4oPhZ,true,293304797,293304803,6,1727888652,5803
77,5tAdio7L3b4Ya8qc4ind69Q6eDjNYJUNGBJYZ9LivmBEzcF6aBbEBxoZLBHAba4MWbRyvUSXdpFgS2KjmaCCcJwe,true,293304797,293304801,4,1727888652,5900
78,4Dxw5rD1tNfYnhjkVWChwf6hCAQnURPgkRR9LerxM1ExDXUFtoQ29DpaYgWyYUU1HV7EP73GusAYa2rMH8i4qBaH,true,293304797,293304802,5,1727888652,5992
79,3MGuBZeQuU1i1LfvYUTQpTfoaS8yHeQz73qzCfv2Zeyj4kez1EmMjoG3R3uZ1vc4jwxG8BZ92ohmxYM1yTy9QCq4,true,293304797,293304800,3,1727888652,6227
70,dutWRDigt2HZh7xAd9AfcSaxcJ1AnstxA7NyiLo1hRkPEnKub9oqs2PBnDTWVrb4m3ahXLYRPi59hyaJp6s4W9q,true,293304797,293304802,5,1727888652,8841
88,rb1CSqhyxfTfTkxZR7wG7ojtZqKY7PCw4MA5LRQ6uSdAALkXNrBHH5fspVJPxAz2Hu8yoFvAvysshJGMsiGYSop,true,293304820,293304824,4,1727888662,5412
89,dKbGid7kdED9NrDwKLKt9A3F3CXJKU3WCY57M8qJM9j2ZEP7jnsDhPYUWmL2SBq9azwJmvv2WuVce3cBwvQNpzh,true,293304820,293304824,4,1727888662,5413
82,31jpyma1TcBT9Hshqi4qkQJb9euPHMESKXiDEZqjWuzjLfGTqGoPDvNggWyTo9PJo1ujWqwMMAWG3C6aD2DfysKC,true,293304820,293304824,4,1727888662,5453
85,3s1HPiAaF6dg1cePitr1EWDHtTajA8B2NaJu2jDCrkuoVt8fESjvfES4dezZKdkGaaEy92eUJbxNGJJkJapmP1yD,true,293304820,293304824,4,1727888662,5576
81,AN4ZSFHQoiKxxfxxmP9iVqHaMQHHVQNd337jfHrf6BsXGCPbk7YdAW1EvKtmAXP9NVxi3BoGd9LjYx7h1PXcuxh,true,293304820,293304824,4,1727888662,5649
87,67FLzdNmECvgCz3KPY8BNgRmEgsiZ4wenjVEijUEcYtqMYcXnqu3asC2By5TcL4xm16hdA5WN7xuY6EqcGq2xNcw,true,293304820,293304824,4,1727888662,5774
80,5Tv1FkkWAZvzs4Qynwzi1w113e4RZkdkfEtRL9jYjMSrWkHhtU4oaUc7PLepm2MTtHqDQFe17swh67j3WXyAemC7,true,293304820,293304824,4,1727888662,5820
86,3HCMRtnxgaXUV7p34zLDyN9GDJG2e7A3TewmJ5eZY5ComRG1fYBs9M3S4sX5nnpMivAHX2N2qEygSTU55edmXhw1,true,293304820,293304824,4,1727888662,5970
83,3kunU2vFRGSEqCcG824SykMGkngwMNvDch3WC5RR2qnLhxZ9hbTtUCuP8QfWiRmXJ5XtPa95fAaf5E5CD3qa77pF,true,293304821,293304824,3,1727888662,6321
84,3Z2WXAuBq9usSL9u4Lz4NmUzBWJaYgfq7oUBnSJBiuTAoiMVqjnATj2kNuZF1EM4EthuqA55gCA1dgRQGmFLUuYB,true,293304820,293304824,4,1727888662,10922
97,3kNdouCCkqoHN3XckcoAdPR2eSnU9L34HSAq2qQsDuZGtXubfJakzd8f8UpfQ29h7TyGsX8QDx9k4SuFF6iVefQF,true,293304845,293304848,3,1727888672,5310
99,cbXSjAcAzpT4rnibTYqhnSXqx2tokv1ZDasb6bU7xU7rjD2cjG2zLaeX1JtP5r1ZebQvKwdDYuKK6d5Q5UwhEYu,true,293304845,293304848,3,1727888673,5299
94,5A2XewQ3URbo73TtgTYrip4DqoRzdGDV34qHW9ttsc4FGy2372PAvCZ7zvzwJxRffbt2KZkXED9A6ugvxmnAjAJf,true,293304845,293304849,4,1727888672,5382
95,6stJnV7LTdTFhUxWHiRNUstxnsPkUBHbQqeYg3bZvv5rXLdcCMT7tXXwKgK6N7MDgZcuoc9F8gE9EkMDD7dwVxu,true,293304845,293304848,3,1727888673,5400
96,3kGdC23bcMrosCTReKsjLjhifnEn5UBPu3mq5csfn9SNvSrWLYiEGtfRDShRvMCipyuCo33KhesgHB2VXy3MBszD,true,293304845,293304849,4,1727888672,5406
90,2UUAZqKzcAj5moLa2GScrVSR9EKcJJJJ9rCh4JmcTe2Kc6rPdnMuDJ3epCnmm7PfZmwcsxBjSB6M4gskDo2FJuvL,true,293304845,293304848,3,1727888673,5387
91,4QHwJJ1B45U59TStpczkYq8YTdDPPbfcqDn55diXUP6TJNjxeLX41tQQGmrunADSAn3LEYmpa7E2EwyE9R24AbEK,true,293304845,293304851,6,1727888672,10518
98,5gfrr3pNosLbp4jSF2qPBceVkfrVJDPjKRedjfJhrz7ANDyqE47kvNAfh6hfv7EzQcox4T6Sab2AdagRUQcJAPZR,true,293304845,293304850,5,1727888672,10610
93,WURY68YBDeQLrBHv3vo3n4qbCTmMryxT6jWGEzpR9eyNDTnoSoba6KmfucmpoVyGiFxpvn3uaPnq3CVCv892jiK,true,293304845,293304849,4,1727888672,10620
92,5dDuZdFYfazN5c5Yav6c3f6s8HBHXyVBdiU9ACwZ3R6NK492kBN1yFHrrVXbKtjyAC9nFjFN1VDSWixXmkytAXBn,true,293304845,293304849,4,1727888672,10702
104,wjojkUK3M6aorm7BsUAhySPxA2CKzfgV6Fi8UPUsgTudLkxrbui4f9EAq3E7gBM2tnhTpHFNvqtBREhfTg8zcqA,true,293304867,293304869,2,1727888683,5221
105,RrBSwqtQ3BL9EKYKh5g7z1iibeDogda1o9bnZfAHDrfSQMY7CWptFiRCLZqr6Nhetd8XzhuQAbj3YrRDXL41W79,true,293304867,293304869,2,1727888683,5282
101,45jMhHJZ7pDQLhtDZjVceGm8vHfa1yzANgA4yVDtcLoPZQejC5KbZjHztu78VrguXTRarYhPqrsSqb4SJb6iWfGF,true,293304867,293304868,1,1727888683,5301
100,5cdstdvCYruY2rPmrD48ARqj3SWWK2JEsqBeMTaVZzEbG3D3HuvTHZMH4HfwkyVqDVvSveERnopWhgNbCEEHno8K,true,293304867,293304869,2,1727888683,5305
107,294sDnVxRwTqwRU7M42jruBShEwzRfLf9hDw8nBjfAASCTZLh61YuXkT3HC2WUQMMjUJDwvdvPCZTF7HVbsLuSwt,true,293304867,293304870,3,1727888683,5277
103,2wNtStfrLDL5dT6ovsSmp7KTHCXdgoo2fNgGUT5zLvznw4trnB88K4QZQj8n7sjFGWVmoeyXqHpW6TiNN9CjX2rZ,true,293304867,293304869,2,1727888683,5319
108,4JgQarRNya37JQe9ueT4RvkffgLce3QkjxfePfLemt8izPUF6srjWdTXWqeXSfnUWmHuwpNYy8cv1nUeXq3FReNk,true,293304867,293304868,1,1727888683,5331
109,5UHo48dnCA5cez9iMHip2nSynNtmuF8XXCxiTUA9Au217fCJeZLQ4tRUNBWG3rTYJFfPAKxgMPYsK82TBW15z4Ar,true,293304867,293304868,1,1727888683,5372
106,5toxzTw8TxfKh8fBDZveXjPK7EAfardPD5cPMDF148vzefEBabvrSjY6xV7htS7Zy8ywu6HioGAWbPzRf7BKjkaP,true,293304867,293304872,5,1727888683,5380
102,3hUzwH1PkD1D1kLkaEV6njNJpyNwyN4wEvYofDFDqx6xPaWqCHuA8qeM8MEvkDTmutSGFhFqsBri1qC2Pmh21LQV,true,293304867,293304869,2,1727888683,5417
118,5XjsfVGJf3tyoPE29PHKqXnTvu1csoyDwoigfjn36BLetD5GXQZtPGbs75jGyq9T4UzaTTnk5QRX1fzDVm3tCkbe,true,293304886,293304888,2,1727888693,5268
114,3RcAVa4hUNq8i22BN2bBbwVaJH6UGSFBiPcXJW4RXTL4d9hNfQhC2ShpKjvmg1ukngTbZZWRjvQ6BzV5zHSyHNqU,true,293304886,293304888,2,1727888693,5298
117,35k3R7DM5ZN5gVzFr5ZaSX1nz32iLAnG3fXLAQBdCm5RTDDdhyPtq7vWJaKro5XizcVbK6yBSPxaWLCqi9VmjLqh,true,293304886,293304888,2,1727888693,5292
112,56tB19ZXo1M2ofcHW2LUKGFCvrf5yryeGFqMnNhHbY8AL7hxLpKcHsLTVEFM9EPAKYdQ4T6GxizcKDvicCN1aN7h,true,293304886,293304888,2,1727888693,5286
113,3m8sVXqCYTpb8hTy5u8eaCARx7VhPy6jt6xGnPhEjuEhzwkxTX1F5DMZuy5GzrLvtgVdP33PrkrzQsesaUn8rsVx,true,293304886,293304888,2,1727888693,5291
119,3BANHK6okFJpDgRKFA2EfTMpLDDNJxcpLNhquJzWcPqNVdCHPoqzxsV7H8Cdrb9fKddvR1mzJtxXDF9CY9whcGpJ,true,293304886,293304888,2,1727888693,5302
110,4EUZErZLyhZ4FogQAGZH91HKaUnNAUwezEuqrQw3idjMRhMFFKbKGgtLAEFDMDasSaA1DijpT1gbqTngZrRZkUZ1,true,293304886,293304888,2,1727888693,5309
115,yHosNqRPY61u3CBocK4EWyvm6VXkZ2PV4tUrkmmo2sfvkaNHDGcdJMWpWGFTdyMdmzxCgLaDmvH2eBUh6vtiV64,true,293304886,293304888,2,1727888693,5395
111,4E26vXk2rkLYTKAwAxoL8ipotKuCWbgmpqbmo6efNtjunrgetqzKnodYYizU3zbXpEghra5wA6Vp2NbGfweGM26S,true,293304886,293304888,2,1727888693,5387
116,3s3JPmNkT8XTxD8mHJFJTtrHos1fe4qLgg6efAbK2RmXjCiswCFXgCJFRjhLE2JaRps8dG15eTt4rjz1nAsmuN6F,true,293304886,293304888,2,1727888693,5399
124,3ZSJVZUyvzF8Smirr2bpn47ptoNtBtkhRfU9skty9QmPJXqcBV4TtaZR6yvHpdWWYmMdNmJD2cuvUy9bn39suvwH,true,293304907,293304909,2,1727888704,5203
127,5cKAaXaLG9EVK7a4xFzow8y892QwmLZ8bP3FTg2FFJNzoVpSgxghCB93sACmRatTTBpYT4egoRFLjM2mZ6hd5GkF,true,293304907,293304909,2,1727888704,5197
128,2PHStBZS8hFAWU4x9o1WRmrWyhcaQLbBcpqjsVc9ZN98RCPZjaSodXt613HWfnkoupwwabg8RuTCqLu6EMozTdPa,true,293304907,293304911,4,1727888704,5199
123,nv6qXR8ChrwueVrzuJSfhGLUHzHSULg6i5FZw4KJRR8mhwK8DcFfM9zBeReLYDT3s7fw2w48CBofTUc6bfyN1GR,true,293304907,293304910,3,1727888704,5288
126,44bvww7RtbC5SGB2ntzGeKvLxKEmYvHPip6nZb8anXMRqv17EKoe5tssTDGBKy82ciCP52BVVWEy9VTqWCgqVR42,true,293304907,293304908,1,1727888704,5317
120,4iAd2Jy9s1ZuschdL8NWjkxBz7VHW8jKNngiQpuzg6GivYWTrrPEauG6dHkMeP7mLsYy5dG1RG84zdyqtzyAkGDd,true,293304907,293304909,2,1727888704,5335
122,3evzbp9ANWCdfL9znaY22psakWnzS1qAi8kpUphnGAjvPEQxuZWkmpz4VYbpvs4WMXPX5p9WSmUHR78hgPp9ZCxn,true,293304907,293304911,4,1727888704,5324
125,61Tv45XqGf4QS9RVUcbw9B1yHxM1wVw4KYJm1TH5spvhUZ6HmaEeEUmuaxFHVw1RLdRNXAXYmg7ZPBmRTnCzwzDf,true,293304907,293304910,3,1727888704,5282
121,3SvCW6v94zThHCpShHNJ68o4krXdqh7keDUJjBNewpbDot8Gt8WizfdkKe5jhdhiUJvEHvYadoQohW6L1qnPvKb7,true,293304907,293304908,1,1727888704,5403
129,3QvJFDc148QT5uVfnxxE1pjGkB9h3BSzmht8LJE1fHaNPzQCbYZWAU3JWWby2tUXTSmVmcAAYTMo5J3a4mgsStE5,true,293304907,293304909,2,1727888704,5390
133,5FnbvvCQ2Bn3hhBnNmpJLfWLxSJcVmXXX2UPMU6VkUMJaSdMs5aYLvTBbHKePkjwrjjtTo2PSzYAcdg5gi99rZ3p,true,293304929,293304932,3,1727888714,5189
130,2G3kaiybswaw8rpwUcgm6mm4ppSAWxtQ6oLQnoDtYV2h627rZtVuYJCicXkLgtC1MPH14cWKYx2rbComha4m6mdF,true,293304929,293304932,3,1727888714,5203
136,4XHqWU3Qcg2WfT2Q6rG4bhxqeYnyn9mFppenH4ejuizZ4ZQr6hTyz2Gpd2Aqg7EMK45sviZ4vcmhEiaLwqVMSCu6,true,293304929,293304932,3,1727888714,5274
138,uM1eBAeWJ2hSqGnisrxgS9zbggPZh8fr2wdHzEQ7aenF2XPGJxMzjpCzu2q7zMGfwNCWA2VtrqXXPpxcVpY8AXC,true,293304929,293304932,3,1727888714,5270
134,5T8gNfTqo3Etx6McDfHrBmscFyCuMNTJSWYMgBGYhfQrUYtK3k3TcsgfocNMReDnzaiWXRf9ZXnN5xPnNHrbFjfE,true,293304929,293304932,3,1727888714,5286
131,5UHik348gL9m8zGZaR7pYJJzWtEFJ5C9sbpP7PdUHZA8B6UeZZPdSL3L2WuXieXFkHqhU6tpQSzPJkT7ve81v5cV,true,293304929,293304932,3,1727888714,5309
135,4Yg5pNFubeSV3RGYokYCuzkNNBZEdmhxzxUX7mAFSgGLvRbzvTKxE5L1eSqo12ZzSSScVZro3ZVXxMsJbV65gGZr,true,293304929,293304932,3,1727888714,5322
137,42MZd1R6FLGmPyc4k7czFLqVzBBpsr5JSfDhZFNuD11paZCKwb9dVWbWEGeQpH8y736vaeN8gwWXZ4wZZAEs8b8D,true,293304929,293304932,3,1727888714,5353
139,3p8UPFreiHFjyZeMBHZPLXadtb4GdsYRTMstjwdnRUL1spWPUoB7dbSq1gqefXe1HQWorrpJX8L9UHi197duTRni,true,293304929,293304932,3,1727888714,5379
132,5s5NqAqi6eo2XjxpogVad91ikDeQwv5UpMM9hmSuNUiQ3X3Mw5kVZuniv5tWwt3TnSGELN44HbKcF8QXuEDKEuHp,true,293304929,293304932,3,1727888714,5403
140,4bDVRodrV6Cx9Wrca47M9gzMsxxXVwxfRRWBuojJJoTPQiz6mGx2tZMtL1RrvTu41ZQPJWEEicShNLGynJX7JhgA,true,293304951,293304952,1,1727888724,5200
142,JqXkLZGs6CMctD1KBEgEQoWQn1nwpyg25knq9v4btcMPM9TjuW1uZY1RUoakebC6GU9bYManDiL78BkNndnvv6L,true,293304951,293304952,1,1727888724,5206
146,Wy4T6ftyReCqaXiHeJgrUg9PkdinmSEJmpx8R6uErdhDTHvuj2dtCL7QkEwkYAYGoXosL3BcqAmvTV6gfNhEabE,true,293304951,293304952,1,1727888725,5192
148,3BVTEg3DpZTAVwF5U5kcv1V4X7ckctWYdWxUDTmuxYjdV7TknArL3deh46DKP6NjxENgN1i32h77HuzgurS6Luet,true,293304951,293304952,1,1727888725,5200
143,3GdoHCwoJS7dvJU5qegMR95cF3TkXAcAgx9fzHyKrWEsmYYCpR1dAg8KKShN7QBdFfy9urSVTpW2zxy2whRq4nKa,true,293304951,293304952,1,1727888725,5309
141,5z8uW9ujzy2gDFqHVbaGsR5RB4u5yuUMaQqH5onUbioQPGWoAYA8hSLepbrCL1Jbn1WxTQNYTCXthwHqq4dj4Ubn,true,293304951,293304952,1,1727888725,5313
144,3r6sQjawiR3Q79SDxiVKLjcYxWLiDDCwLTQeNhBEdckPALfDu7mUBvLpHbA2jGtqVJDnsJV1qVUkP31orfHEojhK,true,293304951,293304952,1,1727888725,5333
145,5sX7bsx3LwSviiFQZiTn5CE2P2qXvkLbytCoX6JkdpH9AKhx9LfE2kMsHs2LKzsfkE8jADAfTbxKmPVeDhUwSadJ,true,293304951,293304952,1,1727888725,5362
149,3jCjZAHS84Ygd8Z1fwq9My9JE2hzqsteegUUhewkCwQmGge45hXQ2ixo5t9JBDBu8yWwg4mZyau6iqJMrsEHQZXA,true,293304951,293304952,1,1727888725,5375
147,4K3n4E1KABS487pms5xAgiq9yW2asQyWX1NSqmPsP5JEiSZeQsYUyqQMTSCfKY73cAipsiHGeQea5rEZxCY27SNU,true,293304951,293304952,1,1727888725,5431
158,4T81mMCHRwgwfzsio88nnUXHqL4wn5dcZQAsw9EcoTvVxSCnQjHTwjMmyCZijG6QYmYQmqSTzxZhcTmGagrHcbJG,true,293304975,293304976,1,1727888735,5192
157,3P36gmLVNNZSv4qBXUci1DmvqyCJ6TTttwX1PoUuC2kp5YDsNGkvi96khzA7c8zrgfGusY4xkcZgYQTGanw681AV,true,293304975,293304976,1,1727888735,5192
159,3Ht5TAvKLq8xdJer1i57Rz3zZUGcodTytAJuBjWCZGZoh2VzoKYpTFncDL1oWdAfRer22GjRtJMeB2ZVMxcymqdc,true,293304975,293304976,1,1727888735,5216
152,22KoJG8MG4g1vF9N6nR2HTpWYQhpyv7DuKCopr7CC7wcnLD2sRMeExPdwF4zCnRQrCkCYqa99JNqyUEfuNNfEwMg,true,293304975,293304976,1,1727888735,5223
156,3dE3kBG1jEmavAsGY7r4vRxMYZApwqSiX589how1kN3Qo86rELZhXNwpGyTpftdmWZhdxcrxm6VZQ9H8TsLKoNwk,true,293304975,293304976,1,1727888735,5240
154,C2VGWHPhtYAi7sKpKS96AU7sTwcCexFcDAGf2a2jPpt78DmLLsS8VhfLSbxYP3id1norRGkzMB7mZqTGqm9c3X2,true,293304975,293304976,1,1727888735,5237
151,3iNvAQz8tCP3uxyTrMu6AbbiPrCFVHuW5RuDvP5L8zmz4jpsDLjnjWoBKJhDH1MQttRSsSNH8sGACHvy93oGv3QS,true,293304975,293304976,1,1727888735,5236
150,2Lmp4PaRoPaB9mNNMBUgHuv5ubDEGtY9RzxWuQZH4u9qDnPqyYhnCrGi8a4hmi4bVw4H2i6YnfkfFkFydQBUnDtL,true,293304975,293304976,1,1727888735,5223
153,54E1ZUu5tYH7VnpqoAtepWNQnSw9sCG467dAT31MUFzDQvH4AfD4fzQZuQxX5SH9p82kyExrmweXf1UQZioFx83c,true,293304975,293304976,1,1727888735,5293
155,326v48wJvi4ghiZVRYkBNKHeA2RgPpaN9TDS5GtTPBwDoWqSGPJUYzMRaoK6f1SxJ8tBJZHezUpENTALYKxDpyHG,true,293304975,293304976,1,1727888735,5323
162,2woTvAgG6q68gysgmcd8N7fGS9tw82QxzMyef1yfCztwaMLoSX1pv4C3p9RPWT5T2CAX4Ad7ddZF7WxpyLbxPAuX,true,293304999,293305001,2,1727888746,5214
169,2CzMde47wyp4pqqsyxMozCCcVgQkTj8LsaifU8sTQCvPSqpNHjxX1B7K1Tx2Wg8rJjCXFm1Nv6WdgucyRWgY3nkR,true,293304998,293305001,3,1727888746,5291
168,2jMmuBR9cbHX7PD7w6wnB2rrG2Qku9E88g6qEarGTDjPjbNdX3S8ucKNZCLfJZvFMTZKomxfUC8uZqb4XwBJpfLy,true,293304999,293305001,2,1727888746,5270
160,5dM226D267bd2nn2GZ4Gwbpq5YNtGRRQBeRfsTxiF3UkkpC6o6PPKBF9gdva5xuyeQWBwXbiYtBwNfDVqZigfvt6,true,293304998,293305000,2,1727888746,5303
161,5VaiLR4yveJXAugJCshwzZaT6mD2eawuWmrtqyGyH5vuAZkmccFXttRv8iSnTT92wwTSt5kSyvX6iSH5r5cHD6Eh,true,293304999,293305001,2,1727888746,5273
165,YnfEeJGFYqphscv28PBcevCgHbQuPcfTaKKEECsDv29UN23t3MVNQjhRVmyARNNGm7jCgmAYpJw1pqKL8fwYWpP,true,293304998,293305001,3,1727888746,5324
166,31Q6qgnPYfZMWNfaG2sH5kiocdL6weTPcyCQM38NEA3hXNYMwvaduDacD4rm1pPKb16iWsRZcpqsegnJUj1EYkFZ,true,293304999,293305001,2,1727888746,5324
164,5pa91rDfEQDkew7nYF1Pg4i8qQdjwxyn6qQpi1dKR25Q1L7pmZkG8eUPSvY7hhcsnKb2QbrsJrHHeW4mYSSZkXfV,true,293304998,293305000,2,1727888746,5355
163,Qkfwagb6nN4iJFpeUKgNnKHaSg7Prp7w9bvPdmdZU8KKFQgZVY7Yn9jz74dQX8spPAgBg1wS38JBL42EUU2witT,true,293304999,293305001,2,1727888746,5373
167,2B52j7B8vAsmB8EKAn8HjBDUwnrX19gqFcyPhDMRhAxn9qrB2wHW14u83WdWxMkvTBhoSS6yDxtVHvQkbMrNukkn,true,293304999,293305001,2,1727888746,5401
175,QxayZebEK5Q515fhEjNLXD5PxRgXFR7f9VkMwR8GWGSVwJmvHi7yNPJdhkvRrCDERp7ZtNVAkKFHDbTC8hr36SG,true,293305024,293305028,4,1727888757,5195
172,3DwE5cRtBLKPt4xGN4wadjoSgmZ6HTzgF7wga1onJCvtJmF7CLtUbkNbYsN5iFuV1ni2TkY3ZCZ8gNJCRd5cphsF,true,293305024,293305028,4,1727888757,5218
170,3HW9L7RxAtykMiA5C87SWb7UVayawMY8qEPBP8Vvap2LzMQ5rJ4JB1XYSXqqwcfrquD1qsFhucD1UxHn1ER9Tz22,true,293305024,293305028,4,1727888757,5234
179,4CiUy4xk6Vyo3psXzgisLvBpwRUTAzty2DbrwA5kQn3XaAQTJCpi1EwbJsuYWRmNUi4csLYV8sEbpWBeHKUKprBD,true,293305024,293305028,4,1727888757,5303
176,543B3Ym1xNKi7YfcxEXN4k59p2aekKQYkPfM5xRZkTwp3ck9Wt9vno16JnJC2cFCQJjnvoYqGedtyPLojRziifcn,true,293305024,293305028,4,1727888757,5314
171,WyczioQnvJpUfYY5WpFRoi2RkidDzQMjE5fq29kEDkVzR4tPeswVKNqiEqitYcp29n3wArQo8nA26wJ5TJ9kpYF,true,293305024,293305028,4,1727888757,5339
174,3muCaWhCcauxbBjLzZQGiJCexycy8Q75t691jvRS4oXou4hmW1rux1GyZx4DaGSUauqf2qDiXgvb3PAaoKQ7ZRVF,true,293305024,293305028,4,1727888757,5386
178,4UZQZxXXmgbELN2SnGURBj4odzyYc5JL2ssxaYrCVxSYiEUrq55pX3zehLcVKhc3jo5awvcxsDcMHyRYEZGAy7Xt,true,293305024,293305028,4,1727888757,5833
177,4e5mLunuN9ZFQTJgM4UqveYdY2iUDSJfBHocSF2DEnCMeRZ41SDvvJ2ssaSxs3rFs6WAw9cBzPRxmHmsXwhWqcrq,true,293305024,293305028,4,1727888757,10442
173,5eAEub341zDAyDShMFc2fqXqEHqPymYtNmEiWmUYH136kdEkmgNcWWM8ha6UHp37jGib245CT8WEFT8JXYYPRpmr,true,293305024,293305028,4,1727888757,10553
187,2oVqt1ZrvZNtY4p2B9UR72qjL8Z6EetdVC5twfPKuFhAg2WvC6TNByNgRugL5S1WQefcSyjCQqoNJmTWSrypPuRh,true,293305046,293305048,2,1727888767,5182
188,2D3MuN7Z2LaH8Kj6eQSPahXRJh6EFPcjGp6LXusKSZJEGu6j3aFYrEARDjcAhD4TcTBnPuzUoUGQQ79WKJBZZYd2,true,293305046,293305048,2,1727888767,5182
183,2mqqbuytrFPg4Qb9xSMgdHqrdWXgs4VB1TSSvzjEmMYBsEgRmnL4NTHwuSBXoCHzWZ43nbf8ebhSL6CU7YHE82hf,true,293305046,293305048,2,1727888767,5197
185,nXwqm7gDs6iNxDbrDpMrMuYfVWA3B54eu1FzGLgqsEa7vQ7ML3ifRB9XbC3eVVcKy5ypDBRkNxyBcL8AyRuB5Pd,true,293305046,293305048,2,1727888767,5212
180,zb8bnXNd62jsUKJjgN3xp5BtdoG2dj1fQ2b8V8w2tQFdotzLqGy1XNYJQDbzzmjDyZHQau4dceGuPFzqDRnzULy,true,293305046,293305048,2,1727888767,5262
182,4PBpqP8EHRDGEACDzRXKHaJgSaoMBio5LpGWRtA7rjj7zyXiC9aYmW3qsjtt4bWrWqxMmqZZjYCjJQ89ZY8GDPqS,true,293305046,293305048,2,1727888767,5280
186,8Higp3e4MjifzCszCWe63zAfS5v61xVQosi8SfhhBVTujQcxcff3VHe94r3xrk5vb4PzJrMSn96ZvG8yrC9y6JK,true,293305046,293305048,2,1727888767,5302
189,3R71mXaZyYuJMmrmXQmRktdH3viHqXnpBtbpkTTNKW42rbHJkksyKkHdmpVthDXiTXK6eMw2NknwgVwAD6jzsj27,true,293305046,293305048,2,1727888767,5298
184,aqomfeTnEJeeK1vc2Q4tHs8Egy6yxEDe5tBFekQBBicdteaekctcH868XQm9no41iw8wcdFbRKp8UJWsLVBXRJz,true,293305046,293305048,2,1727888767,5417
181,bmVXh1iuwe3CTvzX3Q2FwNrLz536kTWHNneVdcur4h5118sL9i6aq72Vm7A9iMfdsfXA1YGHUkGdWeKTtvNHyip,true,293305046,293305048,2,1727888767,5434
198,3etrWeMSFf4qymvsgoCNpdf83vogQUXcqCAWgPUxx56w5rdm9JnevehuNn8HdgofT7qf4NWUcHYCqBK38aeUBxEt,true,293305067,293305069,2,1727888778,5187
192,67duSqFUiSMAycb9ZwKnPYGRPk3FGLU8AEBQPpVU6kiyVHxGdUSxVYr9qmy8uvZs9RpvMPBnvcEYM4dUjDRfW8zu,true,293305067,293305069,2,1727888778,5224
196,5aub4rr9LFQKSKu6Qs8RaaP773h4Z5RackQLMA3XDZTP8voTaz4iWd19nPNmU82k99hLxU4Vs47KHuDfcMPcudZZ,true,293305067,293305069,2,1727888778,5287
195,SZ4YoAkDL6Ht3bs5XpNVKwtqgHmm8pnsa7FGnteaG1BULbCPPt7sQCdBHtQJuopX8AMGPcXpVNzX8LKGbaaQZdJ,true,293305067,293305069,2,1727888778,5264
191,L4ygpUK4ANm3RJtzEv623Vo8tuGBrwa7FPZA5UzUgZ6VqvVxzRYQNuW1ftxd6K5f8zZ29PvYhRvsGphaVtLZoEG,true,293305067,293305069,2,1727888778,5298
193,3FdNYwdstgfm5U6PXp4PRi6eN31AgJG7xcWG4pTn4kuU2UJqbDCvgHHnLNeFcSMBzaQfRKVdNzwx5z2YCuHf1Mnb,true,293305067,293305069,2,1727888778,5341
197,4tnoXVswa2rYpEvQSkEJeziHxWByQfNaVXytK4yX8j9aQ9dYuG94UZyrngJVGvtZBaHGtNS8xfSQsWwCo5MTA6fr,true,293305067,293305069,2,1727888778,5342
199,3LjVc7sEbMUeDF9qvYbkPjyD2inn5wCLQXK3d52Co8CZKKMPvS9XvrYyU21gx6muNc7D3G8aPHB2tFrpXNf2jJqc,true,293305067,293305069,2,1727888778,5397
190,2JYb3NNrnfCh2yaSTRTMSCZNqSWRanPNzopWm9yATJGjyJqnsM5A41kBzkECcC2tyyiFSKALAW3iFmXPa4kvpm1L,true,293305067,293305069,2,1727888778,5324
194,3srXv4bcZtbBpQhEDwNT49TPqbFiCh1J26m6vekpsDv7SdSN7BewhDrWQsKFDhEWme2xYPkvph11nkSqKhm3pkuy,true,293305067,293305069,2,1727888778,5402
201,nQfdN6jLV3SB7gR6YuH3idZKgy6xew2Rd6x37emhwBS7XphTBs69gwwxnbxNQUaMseNY5LXdCDcbdYeWKngSgvF,true,293305086,293305088,2,1727888788,5185
207,4QYczdx3gWeGH3DwCFoqt6yT1VM9zL26TEDFEEG7VkrhfQdNjrBXDVbsJMKoGdKf7R9bcKuQproWDutwQv1ya1jV,true,293305086,293305088,2,1727888788,5198
204,5p6CKjsNrKQbhAP2czJ3zuXLvTngor1BH1zjkataEWSxDyfn6eW9b8JcKiqhE4RnLQ5UdsHR3dw36ti48AyWxt8T,true,293305086,293305088,2,1727888788,5217
203,h7GKYPLGwg2xgQQpwN53FFhU8RZXpao3aqLGnktPHhV3JU6juPGE6wkwKXBjMQW6TPwp3FKGMvsY5KuX54RTiDR,true,293305086,293305088,2,1727888788,5203
202,vPTnEtYbsU3QnaUSJ7zj1HhwYFdgLuWTQsgsAYcTjThENGGq8H4ryvYCFzAJhFdirHTnUp9QFxqUbBsAct9ZYTa,true,293305086,293305088,2,1727888788,5215
200,U9qzjwENpQHcRzymGzyA881ZZKp6GSco923PEN6qeWf4ELMro5ggntKyJViiHCTy3RNfU9eT5jZqiwMMtk74xNE,true,293305086,293305088,2,1727888788,5180
206,4qYUek3WQ1CxNXC1mu5Djcmzfj1wjgefviyGPa74wBYje8xbpmFTDLxtgVAtZSHhMzRgXaioAbM2AozsexjVoWC1,true,293305086,293305088,2,1727888788,5303
208,36KdEAzfnWA4viNaK2SYB24tvxMWe4Ksad2gnkLaYfHdmgPgqtSxLLkw6sw4WAVX483AXCgWst5heEjTaMQDnB9g,true,293305086,293305088,2,1727888788,5321
205,4DzeLwhMLJoX5dN8sdK5dx7wVLFjNwhfjh71CHs5695r8aGCBdd1Wsoij7u391gZB8yKCsFTqH5WnERGypnbY1n1,true,293305086,293305088,2,1727888788,5405
209,3HJfTgYTKWrkLWwjNpgDcyhE7hnY99k2vSwmydaPkSKkitTevumCYz5pdE6rSEcg9zNYA4XiMcr1Bsk3bnhP9LLt,true,293305086,293305088,2,1727888788,5497
212,4ThdNG16aqmoxqBNfx3Qn7pE77f95hrzHDV3YoJb1mGUWEMSbZhg5rimSMMEXFxzrrHiFRmcdH6sRDh1MKyGbNZL,true,293305109,293305114,5,1727888799,5184
213,S7ugVBfgKixe3xYiLE7956F7AFwJPdKPgsvGVjV7Ho3NRZtSgM7G6zry5tHkTexmbkz5unRuyazhLLX5Jb7wK6M,true,293305109,293305114,5,1727888799,5183
218,4aYiyH8tE7bzWLhDLajfRX6mWirAumMrxDYEbbxjQ3umK1ZcXx83hukgxjT9s6yFkCWq8q3SLJeooeXs5v1qwAzk,true,293305109,293305114,5,1727888799,5199
216,uSFsusPfdr1tQ6yh8GyTGxyYJ7SGBXE3XoQ5kQ1igR11S19Ma9YFCaZ9CAzNpQgpfchYticSgf4MoLzdSvpzaUN,true,293305109,293305114,5,1727888799,5223
210,2sRfj2eZASemM876wsySebJWy6uDFkMPnAtPZAcZ1MribGkEjWhnm63TX5MpL7Tf5jL5DtMx2rYdcK2WuZhXymdN,true,293305109,293305114,5,1727888799,5278
217,4MUbNeoEXbYGrFykny8W5zdecMZntzgRTW7aFpie8Bvh3994CLAaNMhSYxkDEJ6p4Ne1TCbVM7aYaookR4ktZHqW,true,293305109,293305114,5,1727888799,5296
214,2M93gPnRtDu4wqc4tEe7t4fEkLffkeYyMZEH1F5RP3C3tugmtDqK9uDA127gDYNuAibyMjVAhng6Qd8jXvKzfFPM,true,293305109,293305114,5,1727888799,5307
211,rcKhZtG3kttDe4Kt2GvZxF85pp3J4hsH9sfWbqHXYvXUYNWSLKUQ5eTNkcUfaXv2F6rtySQP24riYMwdh11Ufo5,true,293305109,293305114,5,1727888799,5403
215,34r5zKuoi625fQeQdmgwfgQdAx1FvH5yetA4UE1oEFXniyvbPdHLEycyTPZEmXWtKBz2ZFQncpwa7KhjuoV69wg9,true,293305109,293305114,5,1727888799,5322
219,3VbrqwXfEaCm7vkJzfAWHg1y7KGdk2cLieHjSsJXEKe8TMry4fRHE3GKq383F8oTqHua3mhTKYWtzgTYaFuQ1pGR,true,293305109,293305114,5,1727888799,5499
224,44wutLKaKKYiGaRrKCo7qxJYx8pK6ySqQwK3fW7PM5NnWUdPF9a9m8VfQSh2d57LKwkpd2VfLzszunKtHw9KgsnW,true,293305131,293305132,1,1727888809,5191
221,PrXaHqdgSSJkAhyPZbLyEfi9JWJj54mdCfS6JGER8b7idnnRGt9SPtMp6do4CdMTSjHTza3sNUk5Uo8PyydUNjH,true,293305131,293305133,2,1727888809,5199
228,3Pho5LtbDzXxhmCeTvGRnrPF1pLtxjiLC3SHyqY9sm5i2VvqP47tenQBp6zPiRTeDd54TmCVCRKM8DaebTcgxfB6,true,293305131,293305134,3,1727888809,5195
222,kjf7286Qkm9bgS9a6XXP8mTn8DhvRfGrUquvSvpJVH6ketCR2r3j9McRNLDPfEym3L3GaJ95o4PjbWmqiUrGAn3,true,293305131,293305132,1,1727888809,5211
220,vaxQyZXZ8VQxSUiNh73YaXtYMc5x35uRoD2A7FNDqt6UQboxThET3pkSRRKrBUtHHQnmocDckhcBcxuZqG2KPtg,true,293305131,293305133,2,1727888809,5212
225,D6jFYVzXmTsaUNAbcPhmc6cTXfNe1GmPwCGMEp6RrTHWd2hvmfwTC8LUmVAS6HkUTz6eshgnJKjuLS7J7wC7pqh,true,293305131,293305133,2,1727888809,5315
223,4jn1SToFjPy1uegBeUBzYpA7J75k54XJLp7B7EqYpVDzJF9rX4gywBJTws6o1KrSnjyt3ZXZMRywdTBFVDzrNBai,true,293305131,293305134,3,1727888809,5310
227,4CtZUesXUPsa3vRvYKGTsr7g1sAWcfZ7uBUd9RdSv9R55DAz43bfxiJWiYrqg6ac2kLxzJSubv15AnUngaeT9r2n,true,293305131,293305132,1,1727888809,5376
226,36xLEtxfbMWi2b5BLPm6DGsgvjM6w5V1dHy4AMJUM2mCn2zTXAFaoHdbSVUNYc64LUCigpor4GNaTfPR3gthPF7d,true,293305131,293305132,1,1727888809,5397
229,5btfQxxUmg2pAyr4krAZajn4YfN3WQ9s2Bz7P7u47CuJMzMM5DHPTb8sDEPNMQa4zTypC1YTYGvy2FyU44pBWmzb,true,293305131,293305132,1,1727888809,5458
233,3UtpRCbP5Jf31AXCFfjBNo1uCR5AJbkU3a58LbLcRh3q6fn6s5hsrAwYfjQDMerDUaQmcZmJp7yV8tem88tBAGWs,true,293305155,293305161,6,1727888820,5193
237,2hQHGcmqt4WPkqrddaNzVtEdieJddm5njLvPR8oGMsbkVZ6JRxeyPwFNSUA5Jg27k7feHU2hx6UdoqoPGRn2cYxN,true,293305155,293305160,5,1727888820,5210
230,4xoZTSprw65neUFPCfCjgznuTCDW2S1QVbZCeRVUgFEvsRXSEDo4WWgQZJBnEhdL2ot25KmWWhvxmaw3ERED9LSP,true,293305155,293305160,5,1727888820,5212
236,4fdzF2QLWkLZoSX4eNVahArHUJoeXJ2Xj6EV7RQLfKvbQnF4k6gnxKAyq9eE3T1dBQc9JAebdXE1AionsgcKjRZL,true,293305155,293305164,9,1727888820,5206
239,541aV5VA1LmLdp3rLjxVL9aK9ovwgbFqSwKdqMKsYwoztmSChr7Cmj5i8quEdrdYTWx9iouTSfxv6HWUHC7Xd1Y1,true,293305155,293305162,7,1727888820,5212
235,2iTDPoqZKxBn2C1HgHPkETzzsySQ98Pbc1XYVNj6VaRqq7WYQhNE4UJdvzswg9NEmCY91AAACE5BpbEew1QE5Hkz,true,293305155,293305160,5,1727888820,5243
232,3c4gqUEQ8CpY5GL72FUsh5SDtrWb5DdTGEV2w5wKipCPNazeycMqMR7i4NMP1C1kmyY6MeLcUpG6rzkqb8TBzgzT,true,293305155,293305161,6,1727888820,5269
238,2sPzYK5AaKHdPB1yCb1NkzJDov4a5nTmVyT1hChGnwjb5cYgAhS8J5TxN4sfm77UcRkvrZDo7cLbYHS5mvSWXzje,true,293305155,293305161,6,1727888820,5271
231,2P2o8BZVYmk1La7bvrCqqBW973YHLczeoWw6KvLtMjNW3PV8ZAkA8heDZ7zM3pDC6J5XqCh1XXcwxD3pHg59Xedy,true,293305155,293305162,7,1727888820,5293
234,hqpnsyYt134HbGgXEFym7rVArtwLvTs7GWckho5rDXM5y27eC3VX3pzov3KMmGSAXKueqfnfUdESmDJw1vB7jwm,true,293305155,293305162,7,1727888820,5312
245,3BvKkjRcq4Rbz5LmXGvvhdv7novFB21sPB6fVUgQncGc2ZVLM4M7LtwqA6ZiQoUWDZzc9YEM8JGZnkJW8vdDmbFs,true,293305179,293305181,2,1727888831,5163
246,24RKLNZeX5Sh3Zq9vbZMVHGdZrgt6JXMPLS5JFz7x3PUrhUN4pWY3fBhimAp9uvFDLkVwkim6RNboBAfF6znMK45,true,293305179,293305181,2,1727888830,5206
240,3Enyo5u6DookdzBcJ8CCGsAcPztwBx3Rgq14m7aayacobPA5URmu1eyF4B3fus32ezw3vm2cHUqp5FyJdRMMRsRL,true,293305179,293305181,2,1727888831,5189
247,3QnGxFGKvm8wmFL6i1x2e6SdTVZSirLfGBGuxTH75X1kRt8cfpxX3Z5niw3oJfdCwSL5CytY7YkJRk5qDdNTc949,true,293305179,293305181,2,1727888830,5213
242,4chQnH68XfCZ2NxtEi7d9mXpgxAJFc9AucZtbaSSYXgTTRJQbpkf1Gu3x9HhrvkEh94mVXvxtiFWfX5Pk1NJpcPN,true,293305179,293305181,2,1727888831,5201
244,3q3oV5m8rkmGjUCbVEBfu5mWxDrJJ4NADG6noBA8HMh3Egzxhs9ThnYB4vCuvDk4yYujTsaTrj1nkhQCtxvXKjTq,true,293305179,293305181,2,1727888830,5234
243,GEXJHvNVQs1K5Uabd7AufF8xBkUdg8UmZHQ7sZBYG943j99pVL1H7jiemMKX6yD7N8ycBMbXbQgaV9TL6uxqpUQ,true,293305179,293305181,2,1727888830,5307
249,3V15LbZU8M952XWmL9v1Upskfboip6obPAGqzsHPa6x7z1VDopiEjEkJ4nkZrxS5hVi3JSRKWyNgDo9mG4HQHgFq,true,293305179,293305181,2,1727888831,5305
248,46RS12NPZ29PfyTXs1EttHV22NkvoRcdUGbXpAZfssxpzaoDC16u65zhDFfY1dUQjXL733pTmvFrgPWkpWVqnBwX,true,293305179,293305181,2,1727888831,5320
241,3TTnX2UXdzNgemiFhQYY798kM6oDqZ3QZJkkLHE3sC3zE138oQYftL6dZwCJRGoYcJkmmyYFTTtnRbfEu3zED9YR,true,293305179,293305181,2,1727888831,5323
259,2y6rbBPVCZrYaoT5sjTHHrSQ5mGxmtZpvfmsgvemEmYTaZFhPkzcsbevV5nU2sCoKSi2PBwmtgDWevFUY5xkGuyT,true,293305199,293305201,2,1727888841,5206
251,2D9KWyuwkVNyWjzZVJ1j6MRetJxyyriYdjBnsPfibAUpuryke8RJHqxoh4j22hsiJoU4AjVMpM1xUkyAPYjbdELn,true,293305199,293305201,2,1727888841,5192
256,3EZAbJty8vCoYwM9nVubYQuuDLq3ZKuPjn7Z7mEazosPCBeE2GLCXPGHSFi6p4WvnhogLiZmDJcVCXYB1zdHqmof,true,293305199,293305201,2,1727888841,5218
252,4h6cyfRfnww78VZD4BH6Qp7XzmbXjBuGpAG5LqEu9kdGuCNhYp4B6d7wuJxCqCFWUGQZEyXgZczLpreRoPpS9baW,true,293305199,293305201,2,1727888841,5210
253,2wsJj7w5TwZdUpmpXTWDsUsu39omtRSPWbDYx86fXtjhxjXKgaNyoyANNoLMoNGtviNsytXE3E7BHRVeqAB6GeRv,true,293305199,293305201,2,1727888841,5204
258,YaYJknZNR5g9R8Q7AcQGtH63vEt6D7L3zTA3XV5Ky992rt3FmKrHLDrhs8tqHkRUjFPRNk51kRNdsRaqGtEi1F6,true,293305199,293305201,2,1727888841,5223
254,4RggQkVL29Q7LMUjJbfe6UkgDZPEVL3kiEDCke9wyRv5gs4SFSJiCP24AwhJdQzWGMe62AaCM3hFPkVqjYWgMLku,true,293305199,293305201,2,1727888841,5229
255,4BteSNwd7sKfgxLUfRCEoZJVneC1dBEU353ZucrrYyNCcuXnTZ6UUfjsDnjLD1DMkfgaZm5gvPbZJH2K6q82ARrr,true,293305199,293305201,2,1727888841,5239
257,4Aosn56R4Yc3xpkJp5Go9UCtxJDXNYTzk75VhovmmSSThhwv6tU9frjyi7MsDZgJ7Hih9KzxeJyDJ6paB1f3F7zo,true,293305199,293305201,2,1727888841,5206
250,22crMfeZmSVphHwnd4Vaum3oXkjncETVC1GGzqj3kGMVum3FSZam5dxQE4VFNr5m7t3caysUS3vxZ2u8uU4WhQU2,true,293305199,293305201,2,1727888841,5412
261,2dWhmoC3Ea3ae4NiaoReKaPosXTzqRKtn9hziqH6x8avCeP5yeKjo5ztVyDSbMaHwnXGoUCSW2zSTKm9VZzMhvVP,true,293305223,293305228,5,1727888852,5198
264,5LtQ1qumn7NLX1TyafjRAxsZrUz1rrKVaz3VZTeHjo7JqHmUkjkLBggrsMYiJ5zGcJPzrzrxsBfpXWuzeCDWgvuX,true,293305223,293305229,6,1727888851,5215
266,2fZk4aCj56shGDXquUkFaYjTgjpMGNJeDqcv56S4Cp2tzgp5EiVq9b2EqYMEW7XieRiWxbcWxBJkJAMZiYZyuNF7,true,293305223,293305229,6,1727888852,5208
260,4bDXq9hdarjBKXcrV2Qgu6Er7r98gW1mvkGK1EKzn5LTpNvvEGfZ3LLCK7Fr6mP6Vyi2dYLp1uvpevLAgo68azZE,true,293305223,293305228,5,1727888852,5267
265,3ZE7RDsTUghHBo6g8qRVRqmi2AqmDDb7GdPBKnRDvV3GVmqu8h9UPLmqXZrqEWiV37rRYjfm3fp1E1wJVZBwyqJC,true,293305223,293305229,6,1727888852,5277
269,2e8qBNwQftr2CVK4KLM8WaiRap82RWFP6DeJWh57eCnmZusaGqKi9t2yieiYhECqgtexZwq4X6zF4NkwyGBBCxNv,true,293305223,293305229,6,1727888852,5287
262,34RXrW3ctPhRRzV7WfAEXLUtnW8EkL1agqz6HUP26yGKSuowFQkvNtCWbCvKuZxd5Pq4nEjw1DPyYg7JJAbKVt76,true,293305223,293305228,5,1727888851,5299
263,d3gzk7avWvXZv9kt7s9dATFDHBqLnwSzdVSuZj1ngrDV2HMHEoQ6RWHQqjJMbWErjoX1Mm86844QiutUc5ga2Vo,true,293305223,293305228,5,1727888852,5327
268,2ZtY37br5Uygoj9ea23cpSdyEkLCNf2NaWXK97GgkmdCNaZT5iBaa5ARYMxAivb8L5yLxEjVrzkgoGysy9T8tQYe,true,293305223,293305228,5,1727888852,5362
267,2cQxk8pvq2X59GWCosbfGHT4H1GH9qenxETghsSxnVaZvuKmVWjmMiZKDRFVFVMwr1odVSkSwNfDehXqh8acRU9P,true,293305223,293305228,5,1727888852,5302
277,1jscLeEYYasdgLjgVm1H1o21h4GToJnupWuBb6Dw27BVWRJEVH9FbEaYALuPFEmHPUMjCrrLberBEcGgNzGSdk2,true,293305245,293305248,3,1727888862,5187
271,3MFXB8bZ7LANGaYnY5f22j3XStiw9EsCnUwkAsYoBwtjps24QnCAq1A63Lr3hFwFfvQoqBJEMjceW8qApPTBxNxc,true,293305245,293305248,3,1727888862,5195
272,66eArzm8Re5oyc3ZJhv9qf4q8VQZXqPQogo8XBKJ6ynJMtKzYHoqQm4W3kNJ3dzxxESWGMpwrLHN3gf2gnZd2Uqn,true,293305245,293305248,3,1727888862,5170
276,2PKXu665UbX8UwCzm2vd7HmZ5ZkofXLhGPD5ggmSxg85KJBTnE5U1RGxLWnnxnWob7gXaTDHjxPwKrB4V7dYnj65,true,293305245,293305248,3,1727888862,5181
275,39qNpRFNcJbWsfyVsZBikUK763RfLvJgiMJ8hUqzDL7G2f8MTqHztYTHPyCyVtiepQCZfsNHUzuzGEatskVnVw13,true,293305245,293305248,3,1727888862,5222
270,5Z5tueHwPxhE6cmFPizNJ69C8kLrqFnwRbjc66AZUJncsQR2s15RgB5YVQSX73tp8pnK96jjezF4dCVhZmQ51NBn,true,293305245,293305248,3,1727888862,5274
273,3URwJCv9aV3ofTiVvXuWxgWwwnkpc1pUG9WoFqNj9oRY4Q2gocfBQRpugVYvtQSQETMMZi2nDSfbjvdLM9yLKwib,true,293305245,293305248,3,1727888862,5282
279,3hARzjAAtD4CafXndTKMhsxoHbXwDV3GkJVVCz1P6wNQJrcJhTh9Tx699ktFBk3DDtCKUar3k7FovaTnufYceUFz,true,293305245,293305248,3,1727888862,5281
278,2xJrzMjhVsi1DzQeS1mcuKaphjoGe9UcyPazZMXuAKEs4L7crGjkee6kmLS4wkv7CbWmgLmJVNgNNCN1XnCutoAo,true,293305245,293305248,3,1727888862,5301
274,2bhGvwLJJerhBVZR3uSBW3guFfnuUemHDsTrkfc7Qnu3HcVJt1x2zPqxz5AMGv9Prd6tEtSDUMcXiRMUwS7qYcZB,true,293305245,293305248,3,1727888862,5386
280,3aZRw6iXEeKwSoThoRzEGdT7geVrZN5753PxDQg99g5Fe2QkD4CCTRr7noeM5guJEHWRa9vaM5iuHHV6oGn9fEkh,true,293305269,293305272,3,1727888872,5175
289,2aGMaUeQwoGk4f7dwmf4po1hHbJsNN7AhVk7B5jkWYyQu2w2ckE8LVEhZNjLEGj92yGKhk3tGpWgfZtCbqGzFpUo,true,293305269,293305272,3,1727888872,5189
281,5zKZnv5zn94rfGQDJDfFT3Ypx8PZuk4crZy57DukWdzEhbzG2q2PVfiuVHnYm4jKbuX71VtrLM5YfSYMBiVkcyKo,true,293305269,293305272,3,1727888872,5231
286,5sePcDaC24tFYLgiKcJqANqtuDvegW4twc45oKz3iCodE1gNcd6i5py7Xmb6QPGrYWPWcGnBYnWyEZrZu7U4CckH,true,293305269,293305272,3,1727888872,5231
285,62B8166wniwESiiykKGaQoTWP2n8PWc68ig8mpgNtJ4SnLcfw13LGVEUeG6LwBv1H5aAW2qMdCYwVUtqCNhrPKKn,true,293305269,293305272,3,1727888872,5228
283,36AabwcXz4NUZm3wtABE6BAUuvtpR1tLLwZKc8tgZJBD96wMWXjcuXFTYmEQnYZ9ovZJbW38PiU5iG9xrn6RdK38,true,293305269,293305272,3,1727888872,5283
287,2QrakwXKyEbU9h2jo9TbjeLHmjSUKJV5G1q6vCbSGeZ5GzPvUroW1jhVXqdErdociSttp2xidCBVkDEgerMxqnsw,true,293305269,293305272,3,1727888872,5279
282,X5QJirb9MPsAXpe5wrErLDLm2m3mXqFLeZ9aWST9xnuCaNQfksJNb1EN65muygapx6kKnryvWLTb2NJt7isfdZ3,true,293305269,293305272,3,1727888872,5283
284,4bjS329iUycp4C6ELk4K22cSq2gQwS9MK3DGDDmFn6618UVvT1ARP7cpGcsrpDmncpVY6j2K43kUroi1LpAc8Uqr,true,293305269,293305272,3,1727888872,5310
288,646XAJSw6MdVuaanygbBM9vunSwrr5trsnNYoJqQmnpFjYzfQT6BMEjzGy23KfVV4u7p7EehuyrKfvHPguGK4CPC,true,293305269,293305272,3,1727888872,5350
297,5gNgjPsuCAEkUp2Nt214Gznb1aXYH8k81XeB5kYLhbWGm2cYsjRUaeTAcog7PAruYwwxtJYL34w6dNmRrdnVCpiC,true,293305292,293305296,4,1727888882,5197
299,5zYUjUAHJXvb4iJPxmbJ6zYu53NKmSnbJNXHRPB1A7p5LH67GqRmzjYGwmSgTAKKsnKjFx5mjrQTn3rQMivoJ4Mr,true,293305292,293305296,4,1727888882,5208
294,5tQ5tDuJQLftBZvgMdW8bGhi2cSzr4XpiPvhWAGHJktwNhXrmrZwJHh3XM28DFDuFvGKJeYjmwPo8Y73nRuHwewo,true,293305292,293305296,4,1727888883,5199
292,4iShdbikkT8GCt9t4XS9vavdaxHB3HzipDhkXAcM2SKjpwY59e4J7pa8rMgAz8jgpytBMUSy8Cy4fek4KZqun1SJ,true,293305292,293305296,4,1727888882,5231
298,3b1BP7LpvDvGsJpcV1xokUu3rnY2KtF9dq7dB6dXWMAdEuYLiH6puZ1WQec3C5qQ4WzH2ZXDFDSsYsZW9aMtbQ7u,true,293305292,293305296,4,1727888882,5271
295,3xvcuh5MJdf6dGzsWgT8ygUcTo4v12faaYMu9EB5YoSVJRPcMLNEpn5EjfmcZvspyJ2DWrPHp55J2cLFygtuADqk,true,293305292,293305296,4,1727888883,5283
293,AzpjhUTFU6jbH3qn4NgATKaG4Le37YC9w29VawNKApnbi9QciiryYSq8XUMn7ZWmeBM2Redc9XkX5YSGMknsr5z,true,293305292,293305296,4,1727888883,5284
290,3YFxUeZ3uoEEKAk31XjPTtc3uqmm2db12n3JUmJTxEiD3WfuF5b5wNfFp54cfQUkgzEM43VHLMn9AVLpBR7nbBju,true,293305292,293305296,4,1727888882,5303
296,3Srp6c7QBek8Jm9dc3sgLhcCiKKtGgPkHjkYyaevoMXbbTMnSPGc7KULKx3Td6TyhFt28uUUSC8Fn2g8etTPmWKc,true,293305292,293305296,4,1727888883,5286
291,4rMeBoXREswiqt95ZT8UErhtgqcafidYfisrzAFvjYTyfoMC4834not2M1A2Mz1Lvdcx8mWvK1ec8ZCa8Pd2uPra,true,293305292,293305296,4,1727888882,5377
307,2Fsivda97Kwe1Yydd7qWkZwEWpk8fTS2tTmdFhf959q593DkfCDq9z2GgVEt1TH4bX8gPtUeLQy4c5y8E3AYLdQw,true,293305315,293305320,5,1727888893,5247
302,5W7P7AiHmv8NhnxmMhD1e9tHs6mD8Mo7X827KS4f1Bz8Cx9wA9PLhGAb9mbDJVTo7XSyKDxzamCoim8vCRobCm8p,true,293305315,293305320,5,1727888893,5301
309,422Ba6yaAAr11Ee26fyB57r6gYkZBmiWuzcTzQgMSa9Y3DLQhEeFgJd1zbKH7xTr7fiYV3h9f7Jv8nQba3QGRX8n,true,293305315,293305320,5,1727888893,5295
306,f7xVDMiRSA34wSzqkS5jRQ3TRrAmswxuSWn3tULNRrr44wkA48TsjNdEzJTLtZf8NXXMYjSNWoMtpaUdReQFsdM,true,293305315,293305320,5,1727888893,5303
305,5rWPVfgRDgMjtRJcQH2CoLrCWKTH9DsP9YH3VUiT7YrbWHYwGBvzVKYxare2DNhERLF2fPm7WXdi2VdPcVyNnrnK,true,293305315,293305320,5,1727888893,5313
304,51ssB73epcxX7tUvnZM1rrfCp3Ptfu9e4thMhfkXnfj1abJyuAG7kiVY14GSitCHhuBgfukfrU95u9e7BiyhPxTr,true,293305315,293305320,5,1727888893,5318
308,58gxSsmdvi5TQoScTVZ8LHZabNkeEXctb5m6rugkX5MvqWsjSU1z3uyYzn63noYjfWd58hCA5bUDExkuZVX4vPSH,true,293305315,293305320,5,1727888893,5429
303,51tRe2rhPkugVfTBSpcfswrDev2EBQsP8u2dDcVnmyNkVQRWDkQZTorByB4BinJDboLkF6fRX7gh1QwsRpWKAZmf,true,293305315,293305320,5,1727888893,5416
300,BcP13q95LXC68priC5vE1pHdRsdLvJmtakeX7ZcdveRGBRQK5kTXGo714aK2mAS6NivMgwgsEE6pZjT44JdmSj6,true,293305315,293305320,5,1727888893,5453
301,5oA7n1Da3NZpjyxPMtbxa8fp35CQWUktBYfc6WkBoNkbvLbWB3QoFkzXbx8L8FWSbEBBfTVvb6VMsXKsS9Uyxyjk,true,293305315,293305320,5,1727888893,5478
313,5o4pjRaifQ9Mv9iBcM9BheXhLApFUyYEL8Rg9iftd3aCNqgEV2f4xLPnQ4e9oqrBnRMZyuNp5QviMqd8R2tfNotw,true,293305336,293305341,5,1727888903,5250
315,uxycVdLRaWiUXwvDBvEY3LdrrFBxBTpbenUjTbDs6jWAJnp3h9aWjy3tRZdbXeQF9aoeuyQMDByejDg7488UtPH,true,293305336,293305344,8,1727888903,5353
319,5SoxL49YX3J7wpJLErjAY6wPqXHuRf7kQ9BZ9FN71ZUUEpc269awAq4Qfbhzrb2mT3bwXeqb6TCmHcJhZZnTFJ42,true,293305336,293305343,7,1727888903,5502
316,2D4HezriX2eHCtczkinaLXf2ktKUYAczVXxJhjnMLMcTTAj3bKazt35KArnuKiWn6X3gpzouEApNsutDTompXTyH,true,293305336,293305341,5,1727888904,5490
310,4gtWsGJwNc8FctymkoZv47mQmuJaAkkjraTkRz4xwk5hStdpPYeCTDR4B736bH2Lf7rsQQGZdyRkycbhXx3tfETi,true,293305336,293305342,6,1727888903,5597
317,5UpgFii51aioQknpXoNLASk8rbj4bPFtX3xv833Dbt5x639k9sueY2HNTAAXe7LGzs3EvBnDjbAhiarwcG3ZFEsx,true,293305336,293305342,6,1727888904,5597
318,5PXe7SHmsHyqBNqwRPFt4aiL3x2LY2NGyLmjHkRxQS5nYxvarmqw1fPBd9Lfdjyn82tTQUkWumNUZrqdy2sZ2EGZ,true,293305336,293305340,4,1727888903,5769
314,67movwLydmEyCJCMm99iaUXG2tGgPwkze82MU3XFKvUM4Wsm6RtY39VNCopQFXTWF4fPSTLoAf3cqVkVWPcGfPKS,true,293305336,293305343,7,1727888903,5800
311,3uh7vCrA3zmRvd22FPdT1WJifYzUi84FdkeUbYYCgS39t7h3kg9rs2eSJwB2SqtEtMqKyBDRnLbk9WQt6DU2HwC3,true,293305336,293305341,5,1727888903,5896
312,e8gp8yqBwXPAoAGsiSfEksZvLPtGHLrGrnHYUZ8gssoEBNnVmpNqfMVtVF8P32mfLGeW6cnWpSAMZVmy761g1wG,true,293305336,293305341,5,1727888903,6224
326,3TgfPB2scDz5z2kuyBSFavhTwuJt5nfwZQEYnHzUBqEMhrE7jfv1SgdZS9BHnyeNmBLkTBKQPeBV2eiNnjouAo6C,true,293305359,293305360,1,1727888914,5554
320,2kZ3mjexWFqqv2HVr5XCNdtzpMbyPBrhAuQ2reWCxktMCAMmf9tgpX9wDWtKrUtAqT7qNwSMC448qRhe6AGTmRJu,true,293305359,293305364,5,1727888914,5588
329,3jZ5aemB7thqRAFZmBHQ6mNEYyaUUEHYEJMZVA8ioz6ohRW3EXas53eTAAdLTCmi4bJKuLDg5CMY6RHSU5sU22dg,true,293305359,293305364,5,1727888914,5592
324,4mtBdrNgTSfQ6BMbvkQkqAdZBrgk2Y8ETBpMP2EZr7xDpyqGPoVmzeydczF547jayVC4g5PLGiAW4Mu5qtJvvaig,true,293305359,293305363,4,1727888914,5747
322,4LMe4jsnHNGsDAkZ8LUPPCKCK7XDBBBKf1L5VoJmdUvNBpCpbdWi3qp4SwKaWdCTxcap7znHf4ppJ7oWy6PhWuy4,true,293305359,293305364,5,1727888914,5789
321,24M63r9PT4q3DqHTgtYqXGku2WmY9z3JEKJ3xNfCeHBy76ycdkXCzUpRokQJcP9rDay1eFdZiUDoUQf8JgUCNNTU,true,293305359,293305364,5,1727888914,5801
328,4Xf8oGtVtDzH4ZLDDznKt6ZWEGpouc9FbN8shpbPQERJ3X1RZbP4FCAgn5yMtMadaXwMaFvoewzTAvdbUVAKtF99,true,293305359,293305364,5,1727888914,5826
323,2Dk8bteid5n2EDeHUoXQsN3mrnUfBdqMaUBBMQL5gneTwYKkdmx2ZbqipxUU58aXe2ztvt9FWAHrwfvbnKqLYtfx,true,293305359,293305363,4,1727888914,5897
327,4FV1YLjKwPhFWz2ShuvqctG5UntiVKjSQadwDY3vD6aKSAFZvP7mSp4nwWsMhNRFq7DdkRVmxuhxZPNWmWAm3Do4,true,293305359,293305364,5,1727888914,5982
325,5mSoRd13o1cgEKRuw8seRm4coqRijGj2F55j2fsLwnPRWtipukC2q5SE3Q1oZhoV9aSGcgTc7NxAa8e6w577VU8d,true,293305359,293305360,1,1727888914,6614
330,3rdMnkEUCF8cj9ombicp7Undj5WM5y8cjsnA2wNZRJMwn9EgeXCc2XqFkYA2niBVzgND21tKiCGB4DSzseXSib6b,true,293305384,293305388,4,1727888926,5543
331,5bHNNxrPeX2JR2xi4vEFVwDvL65FksAKzzx5nPV1spfTsXw4Dub5DWEemAEPu3qHyEdvxZGsV1yNDZFJoNBg1y6N,true,293305384,293305388,4,1727888926,5545
339,4ZJiugwi9bmDbFLkNfqtUYjfPym66UXB1pF5MLzJaXeGzHbFX8sxun6BeR8prp71jvd7sqVjh4YGxURSmG1qod9s,true,293305384,293305388,4,1727888926,5574
335,2Evst1TUtL9QPyEkiSdTvMP1Cys91irHkKGNw4fvrv1wDqdbLVqzjrhNZFbRXxa7x3U3aC53XKESqv65bFPTCfTm,true,293305384,293305388,4,1727888926,5841
333,2iJHU3zhm1mjS2Wzq8YYvRhtdhHVdFQUE3yiL7tjM3TZbF66dyqmQNjkoHJY1fZmEwb3CZtCPeTU34zNFaNE1h6T,true,293305384,293305388,4,1727888926,5848
334,4Yak33Ex4HpD3BgZ9Am6pWPBZDqA5yU4t5yiqFmeeFhMFtx4ZZxFjRXPQHQsQEBKg3Gj7G2mcMs6Xgzen6G7VEdd,true,293305384,293305392,8,1727888926,5976
338,2nG8YRds6kCDw9iiFKyuKGFSJZ1jSEkouRtfbgQx1Me7csopADtRAtiFaYUyA9zJhM4SKfrcwnbcBB6vSCm5Kd6E,true,293305384,293305388,4,1727888926,6240
336,4b4A8Pv5pWt1T38my1DDDRnmdZqeJFJDU42cSdgrDM8GfPtUThHkvBSdaxckCk7EigMW3M79dodS6JqNjmZpxNj4,true,293305384,293305388,4,1727888926,6344
332,5HeeGGNWRCHPdk7ptaAVeoVxkViyMSz7Mmj1va5UjU7vgzZAjWPvM8ceGGN8hHUhBaMdszrRJnCnBGhoRYkSwHEs,true,293305384,293305392,8,1727888926,10844
337,27D8AzyjSqJ5yMr8RaPXZJ9pCeWKtHUvgEXejNGfr42pyyt3cS3ZPxxjTRj2rPjZaarX2qVCrjDVidYPZzpypsj4,true,293305384,293305388,4,1727888926,11282
346,7wyQLrV93nzoGDGoJZuqcmxfSz8p1s1CWG85sjHUEFJ8kRbRpzC5YB3kjGdWs1ALyDt9RkhmGmYaWdbEES5ZR19,true,293305409,293305412,3,1727888938,5448
345,2aVW3jAWTeMr19TuVqzn7hGaHRqkZaCCTaV5eLV2ABVdEsuQa6YH2Z9ah15kqHaHZCYuGdPDnF32CqR5hoVjt1eE,true,293305409,293305412,3,1727888938,5468
342,5i1Uq8WsREZ4bbrTBmBSTu8G1YJq8BottkFqjRQJ2ZuaNQ3HawxUyQ6NjPFhBVoMxgx3PpkwcPj9Eo1CTVHPJiAo,true,293305409,293305412,3,1727888938,5472
344,3r81n9kJh82TWsF36i35WY1vR8uRjojaeXwv4mBkGLQaPQQrRAYY9Y1w8CT7AGMPMVc5ui2fvgQyizYTU3kLiLqC,true,293305409,293305412,3,1727888938,5535
348,2wsFANSb1H2TLhQJtnKzY8WfBBhExDE68GyyvaMikED9kPUPqCYYRkCzJRTmL5C24fXzz5HRDo2qhTJ2umo6Z3fS,true,293305409,293305412,3,1727888938,5494
341,4sL2wcHC9XrFbXH5EEYmfc9xsAu4jUPxmeaiiH5eoQjqnwSDG3ZapYPwz8cWhqeAgFUaXRxSN4aVbHqHNAt5p1kM,true,293305409,293305412,3,1727888938,6154
349,3MuSVeboDdVi1wudp4HF5p5LABhhRXZ3eYjdELA26D6q5FTnfmKg17n6fUF4ipN9btFZVaBZsPgB26nq2mnBZaPo,true,293305409,293305412,3,1727888938,6334
347,2GioA6DLZL1YKbnnW7iPoBBcr6RKNzqpDS6TpEsR6Ht54dcMJKFWccmaVvqtbLrYkLbWkKfoAD6M7h4AokHD4Afj,true,293305409,293305412,3,1727888938,10537
343,33GDpDvJ42m3w4nhHv8TfgM9nqnUHmeBto2eFSn2h2tszY5poNnjptSosL2DQTCKzo7HQNkz1UaE3KQ5u83SRzfU,true,293305409,293305412,3,1727888938,10695
340,JKXmU7kGTZQ5pZ6koCQPcUSbQ4jqa54Tfzg4rynBQHkvZeg4vaXw6HL47CqBRGt8WudVptQP9YAycam5Rhxr7YH,true,293305409,293305412,3,1727888938,10755
353,3wiseEn8onmMTxNpmMwrgEMfwqXLV45CPESeEQpAKqqcSWcEp3q7LTVsRJ3ncMgfz72TzSuNBLFoNahSzxyJACbC,true,293305433,293305437,4,1727888948,5411
352,CZWC6Pdgq52Cq39fnZTJMEsxyznB7s35eE61iZHmBgCcvj14gZKYyZ1VZFE4qvuhh7crk2cmD8DL2r2Lz8m9Lw3,true,293305433,293305436,3,1727888948,5486
350,3HCq5rGgB6mysReMoZnCLCGeA5GStJHaTTC33DFAWgaYX1TX3EGTy1Dt39VZAoghAud451FHcyJ9z43q9YfxFHtR,true,293305433,293305436,3,1727888948,5621
356,4H5oJJAH86hExaDmapRnb5WhQbpBJvi8yqrTma1ZR1PDiCn9yqcWdwG6ACKAgqR47qCag9Hyi7SGSWVeuNLwX4VL,true,293305433,293305436,3,1727888948,5604
357,4CQbujJNrAHhnSGH4ycZdU2LsFMQfxtcNH8fzyoewQMd1422FfmtVdvzjeQs5WE2nmw26Jk6fNfqJzypgUYv8S7b,true,293305433,293305436,3,1727888948,5623
355,5m6qsD7awnbLF7ZNDX7jWRJRkqGw1vVjnRv699KYHnS5M2VAjP4JFfgGcF172LP1AUmDBuweSGAMNpddhX3KpCKt,true,293305433,293305439,6,1727888948,5668
359,5ya1sffeUwnxjydvGWeBAq2WcbnVrsbWt6j1paApKV6BaBEhSzZtoJR5Tq4F6hNeTNi1kUVMhjfrjaH4n3gEeUrb,true,293305433,293305439,6,1727888948,5722
358,5ngFiKvmcwfT2or7sxEBwvkf2kQDv64RW9Dij4iP6ee3uWcVKGq6qAnztCQ8eGcpp7tRdVxXbWPTYqdHEkFaLXyL,true,293305433,293305438,5,1727888948,5759
354,3aesQXfHeySydtRSTJpMrFjQWxcz5iyE1TxdYfUMGnG9CMeRp5Ghae1yrgprcf1HNXCEzSPddvc1f4SBNhCWmNTR,true,293305433,293305437,4,1727888948,5897
351,5E6wZW91tTSnUNun1jPqKmcJdu1LVcgPCLSzQ3FeKnDGyENvQkesGbCP1rEef8uzc4boaSxbkV9VYP6YU7HmeLbc,true,293305433,293305436,3,1727888948,6518
363,67X78s8wf3MLjFpYob37Au8cW6TJi5YiAxssv1Le2VVYc25prZVGnAwsT8HMsW2ZZRperXGeAhPVcpxapDv6PSrB,true,293305459,293305460,1,1727888960,5452
367,44GPfy78zsz4BAMgfwwqRzQwaxwc48gScMey9rurxehKmMCJuELSftEbeQRouA36Y4psNWbiGJxD3Jbes49Hcr5B,true,293305459,293305460,1,1727888960,5447
369,2tE5WST7PVCV5fx3SzaLkkF5dJJyjaeGLKrWyvYAxCN5Z5eRPejMa5Nzr71DSpsvinncMaicPpo3MBtPwkAJEnrX,true,293305459,293305461,2,1727888960,5440
366,4XkpVjzuC2sUJzuDnPGdBueTfeaysomLTcE2m8MaMzsBePpjeXtzZZp67KFRJV3hSuL2oGLFSMnJZdek38myzxjV,true,293305459,293305462,3,1727888960,5533
364,537Utbqv5gRdvKF4gtvHVEEPpHHxRXjYRa8L1aSwxYT47vrrd58USZrpALSiARZGmv3NkFbmssoX1gDmo2RjEEL,true,293305459,293305460,1,1727888960,5533
368,5RiocK4R2nwLGwxvNR6GqhvDLzHB59ZqKoigJicca84SJbb3UFhxM185qrLuBtGw9cSPfRwHcjm7kdtDWmBrL8B1,true,293305459,293305461,2,1727888960,5641
361,4KTBuaEtaWS1VC52tFSsNpsPLLPZyemeQr1rGQQVHmYW56GzCYszqPe3NrbNqmwJySKX2cu8X5Vd4zkh8k78xgoS,true,293305459,293305460,1,1727888960,5753
362,3yMTvHk25dUTyM4peQSEjxnjFqPZUq4rvvMtfNHPeHoBmrg8xE1ny1MgayRziR3APAJ8AWAfQrPvz1yv6uHusmro,true,293305459,293305460,1,1727888960,5924
365,2stxW3SjRM3nYW9xo1ZNfwJmdFpcrSpdNmRudMZBoWk3PAuXc3UcZcrcpbSWBv3RTcNPSRZ9AvGxh4sTaz1run4N,true,293305459,293305460,1,1727888960,6063
360,TttzMh5cJsvp1N3Z1w1BVwx7QMXdSjSzNe5T2kg1weXPZLZyHyCzfHmDBKJYzxcHTd1EReoG5VzvPzcdA7CQxTT,true,293305459,293305460,1,1727888960,6170
371,VoagL8pRLgteYE7SqdxcRT6UGdfgyYei2zPd9AVAsvQoxjCeYbCTxpLg3kZG8ZmmmQDGJSZT7BeQ7ahz8Wnrkme,true,293305483,293305484,1,1727888970,5245
379,5RcTsD5WQXwhMLRkUXhrqXYsu1KxTr6QQD1JceHzVvsgvnop2Mmw7hEK5WRCcQspL86EUPSxc6LZaU5X1y9L5Pr6,true,293305483,293305484,1,1727888970,5403
378,3tQRehp6Mv8HzbPf9jdn4TKcun4xrRpvJpSdhGpbuX9vNB686BbqpB6ASWESLuoGtN4qmJqo73SRLheKpG5ntm2R,true,293305483,293305484,1,1727888970,5526
377,3xmUHxyUPmekDVEopWHzBAcvjq9oH3142De7Zvxt72QanWE6Fv2xDG3UFUHEmxjvdWhefGqj56hTF3YibiP5UNW5,true,293305483,293305484,1,1727888970,5602
373,epNEbuiTTH9gG3cddjddSc3Vuzo9VS6qu78rYMdZDoeqGS7V9mt5RJm3kh8DSrvehxFtVaGpKGA94WjCEuhchdD,true,293305483,293305484,1,1727888970,5614
376,2htr2trb8ui7h6WoiJBC96MdEuikkqmxGJ4CuRpucjNxBehdGAMmwLCt6PhggbTzSh7RwExuoK94ssk4g1mS9PUA,true,293305483,293305484,1,1727888970,5617
370,51D8GV6PjfSWbHrV2v9XFW9J4NY8qBeZyNPtqcJxdGx2HTEqEbjCPdRZsLg6RfWSJAJSZH9xxpt78hcWLcQ5QZgy,true,293305483,293305484,1,1727888970,5659
375,Ms85LZePJ7WRvDTmupL4Qt49ZHauwxSmKwTTBoqLVjZFM6Dh8ZWgfo577Gu7ozWP4wBPZ5UZQKyzRkQZKCu8uP3,true,293305483,293305484,1,1727888970,5767
372,bdJmE9wJ9LMcUuJKvyfxuEziqah8kwcdBm4Bguur6jzefiSJv7oJECHWgZLtUQZ6aBSfokdTmC8CXfWXn19L3go,true,293305483,293305484,1,1727888970,6105
374,21nkDbzrSz2GcNV7LpwL624fNCiEVcoLnSr7kdc7rZYuuUAz22tsRQYX9XNkV2HyZzsDwK8HkWU26bN8CQBXamZA,true,293305483,293305484,1,1727888970,6276
387,5ijeH8ZFkwUNAkUaGBSdAia8yoguCywvzxPKSfzYtw4kZZWSBvzXVQtSQXKoTsgsNTUiVZiwmmT5seijuN7E5HiG,true,293305507,293305510,3,1727888981,5154
381,T9jRreZiS6Jrc76a6FvwSVm3NYB4FjiJP8ibsj5UEgig1bce9xMeKDZ1MU77nbb2z6RPS8tFN4RC79PknLYDeQv,true,293305507,293305510,3,1727888981,5396
383,58Px2z6ndD7j18vdEkE2mGq84kzuahs2z3SpoZC8GydMoS9aduXHwhXrq4PrebpLCLCWnhoE4Twcy6yyZuHcmj5a,true,293305507,293305510,3,1727888981,5412
388,2nGTfoepMfcM88hCvx2gZQ1tHoBXRARK6QDj5WbunkWZFw9AWzBVkH2K4oS8n2dKV28VzrzWqUKDZYr5GGwM2Tku,true,293305507,293305510,3,1727888981,5411
384,yCMryimTL4BQ5Ykpk44CGxqpqYY5pdbQtf4tNf8MKXhtLeYQfMJGb6PpyvDpev1iWdpqf3NT2d8DwBmxeKZ3ic4,true,293305507,293305510,3,1727888981,5440
386,21PS6HVFpM7GNhTpMMzwpdGGyJjLgxVErtcQGfEs7MFhjQec9vFEtS1LGojbWLo7Lc9ePREZyEsUqPuXFCnCULxX,true,293305507,293305510,3,1727888981,5478
380,5PjoAzVUTVJZ6xdmtpM1UR5uMF8nFc1k9p9XbUGoBS7iUN3qy8Amux5PGUm71xuoEHwathzjhcHeNi28GBwaG89G,true,293305507,293305512,5,1727888981,5501
382,5UjivKmsBk6QLT7MaCEBPRAKpvnz5Nb2ZpPWAusv8BkGzwRpGPCyxAD6V4JJocYxp895wWnKqTuprrVW3E2keJS,true,293305507,293305510,3,1727888981,5562
385,yBWGx7nYEijv7E45dGwmiZeqoHjqhBjo1tK9g63jWm6ez7i1dXgk17e5HUQh4byUFG9FPEN2EAHnkiPRRYbofEL,true,293305507,293305510,3,1727888981,5582
389,2riRkFgudWyPNwMyaDepndqn5cCFiSFcCCHnjETggudnUDWVQq3X5mDHJmN5TAeSkDZZ7bTobxrYxZ4kuqD74S6J,true,293305507,293305510,3,1727888981,5603
390,4NWKfNmoDoFtE1eUXrXKuoDAA9EqxdTBfi4XvHNKrYMpUwtqNr5jQygczivem6dmXnq85dMJ1DrFoBNKE4Y6gyve,true,293305533,293305535,2,1727888992,5266
395,2m6qQQCJUeZqEghoJMbfu27b3LV2zVLa43dE7Cqm7ZX2dYDEgvzr9q1TzQCcNs8mo5B9FJeerThsz4X8y8yp51pQ,true,293305533,293305535,2,1727888992,5326
396,s8NMSehqY1hBDNk6dX8H7Na3jYBndHKV2L4YstPcCABwWZT59PgLE6YEpK6ZhxKFgZVXTt3fiXpAJ3eMZ8bviZz,true,293305533,293305535,2,1727888992,5349
391,5dZFsvGQuvbYUV13X85hoBYSJEAN3jda1YG8VLJ6ZN7SvVeLtQdGQKYE8dG6w8todpTR3hpiKWXkL6odk1SpUy4s,true,293305533,293305535,2,1727888992,5368
392,5uXKipxseHzhMz8t5T89J1RKsmNZhwVxro38ncfHFD7u8MV1Gy9xtpiCUSrEsKo2mkKwiP1AhR3e4ZCTjvz6gzMt,true,293305533,293305535,2,1727888992,5409
397,48UyQxa9ww8bt8kg177HwMyWjLwFhcC6E6GTatTz5vEnoKSAn7CqYMNLiWAHN9QKyqAnFKpjfzLKfVFBeE74CzjK,true,293305533,293305535,2,1727888992,5402
394,63ZKinMbQCEDvRVtUuaqz1coc28SpN6a8Go2tpRRqGDYHQam76q3bQ5BTLhC4MuPRkYki3BB3SuYSZKHtwvTFy1y,true,293305533,293305535,2,1727888992,5410
399,2Kn4SfPo1Jq5d2bcd9YaXFWAtQCAfALYHEape5W3tp2XzgGr68AsARZ55XhLferRLHaKZASqFMpjvLTzDvvzgMUS,true,293305533,293305535,2,1727888992,5464
393,64DTNMJUv6whurnpbzGfCqQztX2qkWdWeajusuaBjGAdA5SfeYZykSGyiuN5L9UF9bHcncfuN9Cm3rDBqXTYrd3e,true,293305533,293305535,2,1727888992,5462
398,4hESdcbfyJ259pXJtLTJxstmBvMNbSAkkwCcTbsyu9ZwT37D4vyw4sLFd5izMtn1RvNhLdAEifExW8tJZTyE9uAY,true,293305533,293305535,2,1727888992,5497
403,5bzko9Ta5boVjpThj8HGR7NZDzg3MAr4vETuEtrPRusT1qWKPr8cmFScZ1WZQEZMW84MgBUS5N5KySDRdReQQfM4,true,293305559,293305560,1,1727889003,5365
408,4ibxzsLE6Nw3afyEi9X9ZoaT5bginTFfgdaeyoSgtsRQWbu56VTFkW92HQMR3cd8cVFqoYNJnWmbph2VFGEVmewW,true,293305559,293305560,1,1727889003,5367
405,3EgP9hJhybVbTzpc1gtWnseuMq9Lz2r9rYsLGcNEcUztngR6rVxZWsGuPhHRpUCwUvMpYLt17cmBmsfDfRZodBhK,true,293305559,293305560,1,1727889003,5375
401,5iqjiG8kVuZruS3x6k5KFE6phr8Fyc9RjGxpNbCBQUXzZqHN8o5aiiGgUgfHSzjspTrMjB7WdyVskPh2nErNhzYG,true,293305559,293305561,2,1727889003,5392
409,bXxpM7zn1CxUsg6NCU456NhwC7hLsyvyT2dHgyHA3HQgmQrogGHuLKUbbbB4bd8nLmFgNKiMTfLkuXT9S1CfJpe,true,293305559,293305561,2,1727889003,5403
407,5sSVjoMzPnGhfKYts5uazbaGFkkZVGeZK4ojVDgcZe1HNYcwb1auKZB1iErnkpXEL4mjnftVQzZc3RgiBWNCs1Pk,true,293305559,293305562,3,1727889003,5425
406,4WzwnTQWZtaSupY93NuD8Pv1HLPm7jzHkJhQSQUTF6idZ6CPoHipKHXiB9Wx6ARU13aRbfn3S7GSgkdkp5jaYbtB,true,293305559,293305560,1,1727889003,5412
402,2C62t6VHvLj9zt4Ja9GA1wfj88SCeGWSGxVyyUtHTs6R2HvMiJy8pAo26d5BXceU97icDmRinS7ceaqiRahynC46,true,293305559,293305560,1,1727889003,5408
404,6P1ZyRvP99T9YF5N3s2u1kkiZvVrrUqDdXrZVWVcjtMqYhf6uYjaRHdkdV6k88jiExBFRGSYTJkjH9raCHSzDMK,true,293305559,293305560,1,1727889003,5460
400,3bdTbEzmK4ScQi2b6yWtbQVFviRj8A98tgWTQbQvwPYXzPA76UQNUonD3DgjGpa9p8F3kWrHbcJu2ZQdyuhrvypn,true,293305559,293305563,4,1727889003,5523
415,4a1iUsE8L2u7pYHBnffNu13ABMnRex6zHVhwayqTYT6mm5zzvXeYzWd7PTFMYu3ewuPmbgZkioGWYYuEfznBpXoD,true,293305583,293305587,4,1727889014,5335
411,5Aj2QosRCZQpdPjKXiubr1WhToBPyRXeQ2GHfD8gSNWfQas9XJTDNc4buSoehZCKnybj1S22q6vypAorc8rWZZgA,true,293305583,293305586,3,1727889014,5360
414,5ShzkUL6V5Z8ZHiyVW7qD57P4rMCWq3skUtYXiobGjN9A932xR3ktTdLxZ4u7FNptzFVbNZfugBFwYdZYnSA8Mhb,true,293305583,293305584,1,1727889014,5360
412,36DyKxfpxf2pkL3Wyf4xu6ynHJN9rrRJRqWWnLPKLjgoCZ9umMsGY3Cne9try2mBYsYjxwXab49TQVBcFZxqTc43,true,293305583,293305586,3,1727889014,5408
418,5B6Pc7gGKDu9rqjiA9KWqfPm4L3h4UB7P8WwcsaGbsmtgrxViAfkArKR6ExGPRbZqMjcnBvXpZ1j3SNNUDrS5nFr,true,293305583,293305586,3,1727889014,5362
419,2xJ8kqswUPpY8rKZwaG5GpCvUhxVZgWvNVVaocNwfRVZaHFsvzEdwJo5UCo9S7GV5AjdSyqHy8ku1NDvbitm2DKw,true,293305583,293305587,4,1727889014,5410
416,29brDS8zC9g6KszxtHFZ6MtvmcVipYYB8NuJ7LHpWZomHbvFMtkki3SzCKhz1V4K6Z8cjLBw7K49pCKg8TdPmX5b,true,293305583,293305584,1,1727889014,5478
413,KA5e1JBKAL8qMXJSSTBrRh2zYEAdFWV8vDLsJYProawzNEh2MCPMheUcBZFVDGbbMMVpUmgngeP4aKtoK9rhBbR,true,293305583,293305587,4,1727889014,5483
417,2FNAz2EBUu3Z3z1RHf8VCcCtLRrqDGxePiMFhyMUxi79KMZs1tQsTyKXgfJZrJe4TcSt7H83jMVxMrWDoMC7cn5G,true,293305583,293305586,3,1727889014,5492
410,3BkWM5DxWuo1KWZLsUPpXFyeAEE1UKj6UhxFGkN8dNAzeid4F6twEfPbaNLiNYi57GTiK3yk39u8THAHuE55NLA9,true,293305583,293305584,1,1727889014,5482
427,596yJQRBT8rcuKbWvzkhWbb3G6G2MaScX9EiGGSFwpv5ppJS8Z82eu2rDSmN7m7ATK1rjadCQ89nXw7bUj1GZqnZ,true,293305607,293305608,1,1727889025,5203
424,2Hj2K1C8KWnBmN98t73AbcaGwC6gLHWmM3qJ84A3w4jw9Ro8uQLTzvp3DjvgM9cQcwtkpfBkQUonjF8x2pNC9VHh,true,293305607,293305608,1,1727889025,5208
423,5yB8nESFX5FDwiidN1mAqsA8FC65vtuXeS598FvvuWUjtiQwsAMGpDSJeYNaxSdzG2Fk9zwanpyGQpcLWXUcLpQp,true,293305607,293305608,1,1727889025,5215
426,4cUHyjcAFCNfXxuCv9ZwymgMMj87We2NiinrP5ycYyY2wwuZLT4USXtxFUMaNKLya53nigxuvTfxJdtop8NFQnfy,true,293305607,293305608,1,1727889025,5207
422,JBaV5UtArwTjzBR4zbdFfDqyct45Qrz17zdFCyDqPDkXNi4Htx13k2fhE8Lzc5iKxvTXwLVpYF4ycnCr1v8Vmwr,true,293305607,293305608,1,1727889025,5380
420,aKgTqfYfvGWbD7B1MiGreeVfk5eK5vN5HgaATSf4bDPoYyBmrSK85MFBSsDxDw6mFEFqfPV4mYuK96dnQQoyUuq,true,293305607,293305608,1,1727889025,5393
428,3fKeysVPGtKMzU7tS4ZYAhJWzg7Z5A4E9PNQwT4zL5mhYjKbTV4bEqeqN7L1wmTT6TeZUAsPMZ4Rm8hiLdwELdbv,true,293305607,293305608,1,1727889026,5323
429,5oeedwAZifkbQNvg71ySduBgQana1P5kGsCJcsi2R5Mua2se1sxPhLcmXZx4EiM4kxUKQ6uy5QyHFSd5rGTyJKX5,true,293305607,293305608,1,1727889025,5393
421,2vKxMhbLz9Su9Sb82vCV2M5y9nQkCkRxr9yVaG6nh8WLzphafXwedHWrAKYMs89BXSJzeYTFGNfxrK9GJYmG9MUf,true,293305607,293305608,1,1727889025,5397
425,4MZgYMFsUc18yVUd6VV1t86w4Yz4daN952T4WGVYChL5ep73ZXguERArrWKHc4CVMckPrFAebdsr6eGv15xmBEsu,true,293305607,293305608,1,1727889025,5410
431,v4DkJc6ouTpiYLxCYbuk2UALERGwXuWpub8H3eD54zaAMhVSW2nt4QF1eodZBVRt463m5xG3NtJyQR4M7A8j3ex,true,293305628,293305632,4,1727889036,5166
438,2RiLBTVi3U9JS7cxcoAxziSobUfKdes65ngYBRU4kEoPdfjnWUN2j5SSbHrZAHAgiP5APxztN3b6gwcrxF8nhQFs,true,293305628,293305632,4,1727889036,5215
437,23mo1QRRKWjHmfqYf6v7HMsi6UbrYtmuAm4fW2Pzccm9fWi8WcTZAeb8s2y2HUYf6eMecPaLcmBg3fHbivQ7wA91,true,293305628,293305632,4,1727889036,5283
439,MFVQMnQ5aQZjPhNiySWEBWTa6w2Moditvt7avqqvGpCpkZAPdAhCmZZdkhEWu6GsE8af5j3XQXboKJf9GKJpBw1,true,293305628,293305632,4,1727889036,5383
434,3dQUM4upM5GVWUQs9YoBXuT1Wn3z6HvT6EmU8qji85vFzMibcPown7EuKrrTPZYva6ZKRMsKxfZuJj1TKsPktuDS,true,293305628,293305632,4,1727889036,5400
430,cqw9cXEgx9wdQDQrD7Dm5GEUsCveVY1nFZKiXdREHxRdGobAnWrNYTXAy2oRJQoheiCh4uB25DTqR8h6mN6LqVC,true,293305628,293305632,4,1727889036,5421
433,4CwfD9PRLxRbBTjxbQrkgQs88BWqKBMhXERqjnx4Gca7Bzn3VBML2ZEuLvD4LJRyabzcWGgCE8eYbzvjHX15LLCa,true,293305628,293305632,4,1727889036,5408
432,5quRza9q8BmDbsmJfZcCB86oyeaD9L9KT8zpQUHkhpE2K1qBHs2sMf9cuPfghSnUChbqJJAowSGtaPEvpRJGHsBi,true,293305628,293305632,4,1727889036,5445
435,62w3UZpN1y2yd9sG84E8dML4jBz4JF5ux4SuXAVy4rsP3M3kjTgJhmxmQgCMs85iEpffgYc5kmuaSXGjmMxPgcnP,true,293305628,293305632,4,1727889036,10396
436,4wyXaYeEvfv38Mge5Gcjnc4rjmAHmdNBtc5CBJMSczDdmo9u42qWXCf9pMPwAsb4Bi33ALo7n1oq4Kz7o3yBSccn,true,293305628,293305632,4,1727889036,10626
447,2QaRqfq4EohaehMpu1FqLhbqj9QXiYBdVUAJoLDtYAdG3i94ZWatNty6FLjFhmBytrKt1723GLAtL834eCqV4iNB,true,293305650,293305652,2,1727889047,5165
440,2N3uSTAwzgkboCJiH9wpDVKD3dASHTu72GKrzEr28e6t7gVw9HK2wHdFPybDU2zqnt7k7tbGMUR25gj9wWL713dY,true,293305650,293305652,2,1727889047,5183
445,1dXX5LosTDw6XeqhPC26eztfWsJV8b3UtABUTZd4eY8tiKH2xxgLqzLhtpYcZYqRhZEEvupk1h9nA261qiZFx7Y,true,293305650,293305652,2,1727889047,5269
448,4BXuASYJt7Kwikx9HkHymymLxFtzG5QJLt82Va6UpX8FHR2jHWQNW4shnAM9tauqu3iVdHyaxvNaozfH8R6nSCmt,true,293305650,293305652,2,1727889047,5280
444,4hj7PKtTrQ4aMJimbPMEaaVD7FCXkSZkX9RxzV4nvrcatC2TA1yJNg5CRtHpZsWa65hHR9mjQEo3GUU6a5riCjWh,true,293305650,293305652,2,1727889047,5314
449,5R9kWSWecxSJoDiafg7gN2kF5zjTdwjJQgkTXkPs3SHTDtEKV7BhFprg3cL6Qcmfft17XaRS16o4CFEnxjP1v9kT,true,293305650,293305652,2,1727889047,5403
443,4PFriR6rWsx4rgQJPadAESBVhEm1svFLrtBh5GNsqMSEmkndWkv1xJh55YTgcWM4H5g79dnNhQBcsNucGBAoPLwu,true,293305650,293305652,2,1727889047,5396
442,wREPcHXy1yqWvcH3DuxVFssZJoUFoaKixgDnya3Zd7LGifvr5eNBru4E78gyDSGccFDm2QHdh4Labo4aiCjZdju,true,293305646,293305652,6,1727889047,5475
441,2pZKAv8cW6B6waE7hWejqZ1mVmtRBkULLfEALMx7pQbpNAM1xFC6q3QFYAAyjdoZg6unmNX7ZGHrbNyMLT6WAzxt,true,293305650,293305652,2,1727889047,5467
446,5DXFQFVXBwCCzF9djrBLpkEwMRrah3ccA44jUTAk7J6cjKnzEFvrDfpucpgTPkx87juh8QqeJvtbX2WxmeCfdvBp,true,293305650,293305652,2,1727889047,5423
457,2THgbaMug2Vw6BtrTyjfmWa5iNFoym1251oT2Qcf9PTe2m2zBs8YvAqHbGH6pgBXpY2bh8XdbiLPGf6Q5Z7LDN2J,true,293305673,293305676,3,1727889058,5201
456,5ZexyC7NoJ2igZF4yCmWn9ESzyjv8CvUs6rSQfprBjiARNkeYww34M3ryqLqa5ivVCDgeHYcNoVJt3ZbVNKf5R1o,true,293305673,293305676,3,1727889058,5209
455,5iu9XEPykLiFsA3rSFDNpgqALdAT1zBHRNDsM6xCrTgDhqxVEZeVCdzavfo31y3PAgr12pgPLd51DHmBffZ1zVfK,true,293305673,293305676,3,1727889058,5190
458,22ygPLcN3h8awMbvcxU9Hb5aAbh4TfiJ87TmijqzM3UVmvgJsDbHJ2PYGs1egz41G7TSuZF9z1khuqpMHJ18oX54,true,293305673,293305676,3,1727889058,5200
454,4A2CkXUnyqa8S3cgRwE5cU6X7AWeEXSrxYhswfnFjUYd372XdrVd1tXEDg6LwNnnRVcwgi2kPVGRo34oX1R7FNGR,true,293305673,293305676,3,1727889058,5206
459,4qd39NMom96mw6TZV8b66FGPmCdJeZzRG8jw1ZLFCF2MGEBMHgnDC2WHihSJs3ZK5LHVmA69PqD6Dp38uq3nxabD,true,293305673,293305676,3,1727889058,5223
453,46zUJEmwegARGthJBsZZEjZSgu9VDQkN93Yv9CeoPx88FZKUZw3aLn1UUC4NLRkyWcXdU4RQjpUib8P5ErspVKmr,true,293305673,293305676,3,1727889058,5343
452,5h44jqgbS28TCcRQ5FqUmJDMFUbsR1fbDcrrxRXCkNmJ9FKT5yr4W1bcyU4UR8SaYb3g1kE4ymqLkPRHAh4o4GQ4,true,293305673,293305676,3,1727889058,5351
450,5PfdxKoB4ey6aKtsAcWVtH8M1oyLRhZ5w2ZeZxYu2hswCqSHKpSCXmX6dUm2KtzuMAgrYE1JHULPdR8iNcHrwh8J,true,293305673,293305676,3,1727889058,5384
451,LP4DUkGKRgoTRwxSV6kkdHssPDKCoJfJYogZ1B7QJZ6PDoELeRJaf3wQSS1Agm97q4zB5M3o4nqfUdbGZCAZ62b,true,293305673,293305676,3,1727889058,5487
464,5H9RChdFqvBeAUaTtso9sDDnxD2y3xEL58LeTaV8iWMsjthMhsTMBAZVedZ2gMPCheP2mcEZuD6BUqTR7U9wPu1j,true,293305697,293305700,3,1727889069,5208
469,3Mv4eYDVfrmyuVfkGbnyreWGrn13qRH5FWqM73CZyqGRQZf2jZD3h7PgJ49h72kxMxtj6waZ87ECoY12rwVusLty,true,293305697,293305700,3,1727889069,5217
466,3yWwL3qXGpzdPvwNXvfARoUe5bCwJRVSR7T3SEtTaFwLro4U52PxQCfCG3gWhQFD1hzn38ofjtQmcd2cc6Jm9p1A,true,293305697,293305700,3,1727889069,5164
467,3TzcyhRx9zsAai7Thwahj65YARtw2JT1cXWCpP8FFn4aNVotDuEfp2UqtRrFGD9SXqLyCgmRU1cYz6N542vm1xjj,true,293305697,293305700,3,1727889069,5299
463,5DjcoVdQF4zYcsTTEb9TRbt77uizn8ZavwhegJf2Jzv9onZAZXPTLBpyB961oT9zpkxGucJCNi5ZVEMFB1Hx4yw8,true,293305697,293305700,3,1727889069,5297
468,5HRsvjdGncoNrwNpfHYwV7Tbv1xEvTjLLHoHFLPhUF4FGiAY6gXz62GSbtMrum6c8N2CdeyzBW5W75ZN2psmifcR,true,293305697,293305700,3,1727889069,5367
462,3WrkQdV74ei7VgBr8BmcowC1gWQeiPHSYT5v7AWZm8dhyGwS3BzsDW5pQ4FVAcavrw8mQYD2k8UiLreXAuT1Lk6Z,true,293305697,293305700,3,1727889069,5407
461,2QPX6RC6xiven9BjyfVtATd5BSKWomu4BjHHRDJV4pWcagX6cZ7tUV1sgFpz3NtjogsQ57Cbz21uZfTTyg5u1GiT,true,293305697,293305700,3,1727889069,5433
465,55W8edyfB6bXWaeHKyFzEc4u3CQCoHvRdkEcZyRUndV6FANwmV7JVDWLtSQqhcWvDEJoG5tQB752Yb6uGsLsbFyH,true,293305697,293305700,3,1727889069,5453
460,2wBhnJJYW1iysi4TmrnFuk4sa6BaZRMuxxB2qPkXeqz3oSWRUWG18WY5CDa3GtVcBJhNC1mGEPKhURHXeR5pN6h6,true,293305697,293305700,3,1727889069,5468
478,4FVFM9BTgCjETiuKTpAd7nVYF3eK2V6TrMJfSobbjdHZHyyKEcheDR4K2gECMWkQszdraRHL1qLKfikTktowWDQw,true,293305718,293305720,2,1727889079,5152
471,2iEyGSBDFwpCFEqR5PUbuBgMLBUop2teTkdnA6mbBQd9B39n9xpLNXRYYSpV77nCNV3anoHur6bYbHodwR4oUjvk,true,293305718,293305720,2,1727889079,5180
474,4b88qfoE4wDvidb9tcRgQo1nez2m6jmUbUpVEKWBrjrtBddPctvvNafMBmmSP1XAiiu1JJScq8A9EBQdYf62kSjY,true,293305718,293305720,2,1727889079,5199
473,38kfZrmKHe5YhMFn3t1ki6PqqfVwxWUeeumNMeXJTdVkyiwd6HAVnRMScy2cT2NgVmXvnRoWhcPHTgrPKqnrUzGr,true,293305718,293305720,2,1727889079,5199
476,59cQn6fYUEGw78aHjphu88f3m24b4tm5J63rvWjghS7jCr6ZHsvoDNJrjD639gvg9yXn3mJ7RSY73QxJPuqTTog7,true,293305718,293305720,2,1727889079,5206
475,rK2LokiV4b2kbJTcHiXXfm6v5hwpNBNwzuHgE9iNkRUdiikubpx3T3pfYiXdKQ4fNbjfZuQNFCiRP5htmvQiNom,true,293305718,293305720,2,1727889079,5158
472,4RBWikPR3aY84yVV7AvVfCZmN5dLANNQPideh3VzzaxyRzVGTfZWSPQJK33jZa2oZWmNcqXs5jQ97U66mYuhd9oU,true,293305718,293305720,2,1727889079,5204
479,3hrzotMEzbxugVvsKkbQfR5T34h893HiMRdqyUDamuf5xBq9NzLAzwAwmYFaubNeRshwRYDzKsQ6AqDzQ7rMhyuz,true,293305718,293305720,2,1727889079,5320
470,qKTB3qRGbVEyG5divxDLaPUYzsFa6fyL1V8BaFrasNDYLacAk2379bjQwFDHQfiDRuAoN3S43hNL3aV6iUMVnVP,true,293305718,293305720,2,1727889079,5365
477,2ZYH1e9ATNkpZxsScALgozdEtRcDvnSGmpQHJfFT7BrBWXQ698TS3JCJdgobfEnwpc2zG66oYFbpDk9rX58pBUdp,true,293305718,293305720,2,1727889079,5402
483,UxPFHqkyXCD3W9rZsbMdwT15pxfCaPDqNbrs8e9SJfVKQYHddyzqavf8pE9yqsH2u8GnWHwrZstzjFWpoiPAzMJ,true,293305740,293305746,6,1727889090,5453
487,4R2yW6KCCt8K5GMVS4quQDHJu2vHHUtZNB6CsQFN8S1ksw2Qbzx62qWrrd8zDaBow96fJ2XPtg1dq1nWopGZu2tN,true,293305740,293305757,17,1727889090,10559
481,3twpJr78jckJyb8bYp1PBdxHFY9UaYXpjvkJWvPky9yPjxPNAxjk8DtHXseJwiH3BpXHzpfgnAdFkiDQxs3GKNPM,true,293305740,293305757,17,1727889090,10776
482,61UgFW6U4c4ZmC8tveCeTkttUuFM3bdHkyhQUYD3BUXvZAzMVFjT7LGFLjqBSGVyffCPS9rSLovcvc1SHMWKxm5Y,true,293305740,293305758,18,1727889090,11197
488,5ay1DeC3q8UFtDTvVkfokdSn5KcMhbb4k393WB5JAaaJdBW98SCpLowKfJBmzZghZDLQ6F5Z1pdPQo4bbHxMXvFJ,true,293305740,293305761,21,1727889090,15497
485,rTJKhFzCN9py9c5iQdpMR539eDkKy3sUuzwyGcPho18XBjPne3bgthJHrs3Pq36zbSy3QMovTMh46zbgKCjTwSx,true,293305740,293305761,21,1727889090,15886
496,5Hp7a2xPQu9vTf3fV9yAmxbFaNactPMnp5iu9adsXfZgiEBkYe2FT7XubDJvuoYxzAnB6hiRdpZo54sCJUoEy7f4,true,293305761,293305767,6,1727889100,5411
498,EfU87UCe8KzSCTgTaZkq7bxMfvRL8FPj5pCP8bPgCbazdYkruc7eQyMUfTmb7d84V7BbcHt8qeZegpWFMsimmUC,true,293305761,293305767,6,1727889100,5410
497,4mqL9kCqKb9V4TQ1e8eaqUNf1c5iTYCVQeT7npJY56TkPqB14J8Ayjfze9DjPTMzo1D9m2HHwxzvJcPGrEaCiWa2,true,293305761,293305766,5,1727889100,5453
486,UMQE3hq7uTQw4cHiygjXNmWJGSqFvsLxBRyDcvmUAR5yFKDhEqoEnnfshDiQuiZ3aax3uGQZHWXuwmAvhg4vaqt,true,293305740,293305764,24,1727889090,15981
493,3PRwBCFsuV7K7XVpPRtQKvAKPREKmHpChtJ4tYenzD7Lu6mPVRjJeLnr8GaJwe8vS7wfq6NXQWBGvro5hzMqSjZz,true,293305761,293305764,3,1727889100,5497
494,45L2SXb3tQmy1a7q95P4vEF4vkC7gdJMxFPAHktynXwFV7nAFSGnEj8sxq3GUfvpfS1e5iunjteFBFZJ9vtRZfPK,true,293305761,293305766,5,1727889100,5487
484,3WFZ1ZDDhWMz6zNmUADojpXb4CfpmBumbtvGUBCTsvZgQZkjWcVp3efxZkUiP4NmmsgSkfiDtEk3icuNz1mFAJs,true,293305740,293305764,24,1727889090,16088
492,hgKXbYLS99Us5YYXpQ8T79mPMff13Ema2yyNiRWUf5P83k9Py6t7zbLvup4nAJAcU7CbsCGsCMMPnVxNGG46hbb,true,293305761,293305765,4,1727889100,5586
495,3HxQkoTdSg2aEmaqGiHvUnqyebhDRJwfNDNzWFR3AQ5VNa7SYTb9jEQCS62FPJuNUSXoEX2K6RpuQJSTikRhLH1Q,true,293305761,293305766,5,1727889100,5598
480,3jXWUeHBrrd42UdybtA4aiFpDiq3rrY4CM3Rb1ZY7WzRcCPN6wDrpL8V69Je8X1GUxhKcduyTzYQ5ZAkjXRUo3Qm,true,293305740,293305764,24,1727889090,16136
499,28LWPDaDH53KU8vhrFJzfo4farDuDgziuN7wQES7yx3Z1xBHAip7aoxwWN5A9WT4tEZpD8xf5TuoW4bKh1ehji5q,true,293305761,293305766,5,1727889100,5724
489,4V1KbYwon653YpGZDkiyFcQbGKDBzJxvBwC4rHC4tcPFKmTUXPeUC3NKpBYYZ7SxSPshwAS2QKX6g1QTawHD9Csc,true,293305740,293305766,26,1727889090,16356
491,JQR9DMGGthqiTAy3oLt9faSaUDyq1AHQW7wfbFVYMqKs8LPvW6GfvLuvqmkpKiMC9z53vDhaZg3oacW2iweuvp6,true,293305761,293305765,4,1727889100,5968
490,5xwaWckYJc9fcDAFxXxJn4yydKkJTv3anGsA4VV6G2ALXRFXL9Rq4mdJoSiffqd5cQwYjdDvxwEDA9vyXL3gaXAj,true,293305761,293305765,4,1727889100,6134
>>>>>>> a1dee7a (lol)
